kecamatan/_text,pemilih,pengguna_hak_pilih,perolehan_suara_1,perolehan_suara_2,suara_sah,suara_tidak_sah,total_suara,resources
TPS 1,677,184,87,94,181,3,184,https://pilkada2015.kpu.go.id/surabayakota/asem_rowo/asem_rowo
TPS 2,620,294,42,247,289,5,294,https://pilkada2015.kpu.go.id/surabayakota/asem_rowo/asem_rowo
TPS 3,551,283,30,247,277,6,283,https://pilkada2015.kpu.go.id/surabayakota/asem_rowo/asem_rowo
TPS 4,390,232,36,192,228,4,232,https://pilkada2015.kpu.go.id/surabayakota/asem_rowo/asem_rowo
TPS 5,542,298,40,252,292,6,298,https://pilkada2015.kpu.go.id/surabayakota/asem_rowo/asem_rowo
TPS 6,494,259,45,210,255,4,259,https://pilkada2015.kpu.go.id/surabayakota/asem_rowo/asem_rowo
TPS 7,448,255,34,220,254,1,255,https://pilkada2015.kpu.go.id/surabayakota/asem_rowo/asem_rowo
TPS 8,487,262,43,215,258,4,262,https://pilkada2015.kpu.go.id/surabayakota/asem_rowo/asem_rowo
TPS 9,512,226,56,167,223,3,226,https://pilkada2015.kpu.go.id/surabayakota/asem_rowo/asem_rowo
TPS 10,534,216,28,186,214,2,216,https://pilkada2015.kpu.go.id/surabayakota/asem_rowo/asem_rowo
TPS 11,391,243,36,204,240,3,243,https://pilkada2015.kpu.go.id/surabayakota/asem_rowo/asem_rowo
TPS 12,451,293,47,244,291,2,293,https://pilkada2015.kpu.go.id/surabayakota/asem_rowo/asem_rowo
TPS 13,463,268,31,234,265,3,268,https://pilkada2015.kpu.go.id/surabayakota/asem_rowo/asem_rowo
TPS 14,447,269,47,220,267,2,269,https://pilkada2015.kpu.go.id/surabayakota/asem_rowo/asem_rowo
TPS 15,488,245,41,196,237,8,245,https://pilkada2015.kpu.go.id/surabayakota/asem_rowo/asem_rowo
TPS 16,602,220,35,178,213,7,220,https://pilkada2015.kpu.go.id/surabayakota/asem_rowo/asem_rowo
TPS 17,422,131,22,105,127,4,131,https://pilkada2015.kpu.go.id/surabayakota/asem_rowo/asem_rowo
TPS 18,446,189,43,139,182,7,189,https://pilkada2015.kpu.go.id/surabayakota/asem_rowo/asem_rowo
TPS 19,404,183,24,157,181,2,183,https://pilkada2015.kpu.go.id/surabayakota/asem_rowo/asem_rowo
TPS 20,407,156,65,81,146,10,156,https://pilkada2015.kpu.go.id/surabayakota/asem_rowo/asem_rowo
TPS 21,610,158,63,94,157,1,158,https://pilkada2015.kpu.go.id/surabayakota/asem_rowo/asem_rowo
TPS 22,643,239,29,207,236,3,239,https://pilkada2015.kpu.go.id/surabayakota/asem_rowo/asem_rowo
TPS 23,478,128,31,94,125,3,128,https://pilkada2015.kpu.go.id/surabayakota/asem_rowo/asem_rowo
TPS 24,660,279,120,155,275,4,279,https://pilkada2015.kpu.go.id/surabayakota/asem_rowo/asem_rowo
TPS 25,580,307,26,276,302,5,307,https://pilkada2015.kpu.go.id/surabayakota/asem_rowo/asem_rowo
TPS 26,597,297,57,232,289,8,297,https://pilkada2015.kpu.go.id/surabayakota/asem_rowo/asem_rowo
TPS 27,579,371,30,333,363,8,371,https://pilkada2015.kpu.go.id/surabayakota/asem_rowo/asem_rowo
TPS 28,605,145,26,119,145,0,145,https://pilkada2015.kpu.go.id/surabayakota/asem_rowo/asem_rowo
TPS 29,545,316,50,261,311,5,316,https://pilkada2015.kpu.go.id/surabayakota/asem_rowo/asem_rowo
TPS 30,408,210,36,168,204,6,210,https://pilkada2015.kpu.go.id/surabayakota/asem_rowo/asem_rowo
TPS 31,403,207,49,156,205,2,207,https://pilkada2015.kpu.go.id/surabayakota/asem_rowo/asem_rowo
TPS 32,526,258,71,174,245,3,258,https://pilkada2015.kpu.go.id/surabayakota/asem_rowo/asem_rowo
TPS 33,422,186,57,128,185,1,186,https://pilkada2015.kpu.go.id/surabayakota/asem_rowo/asem_rowo
TPS 34,551,217,58,155,213,4,217,https://pilkada2015.kpu.go.id/surabayakota/asem_rowo/asem_rowo
TPS 35,585,301,62,232,294,7,301,https://pilkada2015.kpu.go.id/surabayakota/asem_rowo/asem_rowo
TPS 36,544,287,50,234,284,3,287,https://pilkada2015.kpu.go.id/surabayakota/asem_rowo/asem_rowo
TPS 37,513,316,71,236,307,9,316,https://pilkada2015.kpu.go.id/surabayakota/asem_rowo/asem_rowo
TPS 38,451,233,46,185,231,2,233,https://pilkada2015.kpu.go.id/surabayakota/asem_rowo/asem_rowo
TPS 39,395,242,61,178,239,3,242,https://pilkada2015.kpu.go.id/surabayakota/asem_rowo/asem_rowo
TPS 1,502,297,38,246,284,13,297,https://pilkada2015.kpu.go.id/surabayakota/asem_rowo/genting_kalianak
TPS 2,388,221,29,187,216,5,221,https://pilkada2015.kpu.go.id/surabayakota/asem_rowo/genting_kalianak
TPS 3,373,201,45,149,194,7,201,https://pilkada2015.kpu.go.id/surabayakota/asem_rowo/genting_kalianak
TPS 4,343,232,21,206,227,5,232,https://pilkada2015.kpu.go.id/surabayakota/asem_rowo/genting_kalianak
TPS 5,413,238,33,204,237,1,238,https://pilkada2015.kpu.go.id/surabayakota/asem_rowo/genting_kalianak
TPS 6,327,195,59,132,191,4,195,https://pilkada2015.kpu.go.id/surabayakota/asem_rowo/genting_kalianak
TPS 7,215,215,58,151,209,6,215,https://pilkada2015.kpu.go.id/surabayakota/asem_rowo/genting_kalianak
TPS 8,457,211,40,166,206,5,211,https://pilkada2015.kpu.go.id/surabayakota/asem_rowo/genting_kalianak
TPS 9,488,342,48,285,333,9,342,https://pilkada2015.kpu.go.id/surabayakota/asem_rowo/genting_kalianak
TPS 10,553,288,63,219,282,6,288,https://pilkada2015.kpu.go.id/surabayakota/asem_rowo/genting_kalianak
TPS 11,641,269,69,195,264,5,269,https://pilkada2015.kpu.go.id/surabayakota/asem_rowo/genting_kalianak
TPS 1,543,295,59,225,284,11,295,https://pilkada2015.kpu.go.id/surabayakota/asem_rowo/tambak_sarioso
TPS 2,513,302,61,239,300,2,302,https://pilkada2015.kpu.go.id/surabayakota/asem_rowo/tambak_sarioso
TPS 3,467,247,35,206,241,6,247,https://pilkada2015.kpu.go.id/surabayakota/asem_rowo/tambak_sarioso
TPS 4,540,336,63,267,330,6,336,https://pilkada2015.kpu.go.id/surabayakota/asem_rowo/tambak_sarioso
TPS 5,585,399,56,326,382,17,399,https://pilkada2015.kpu.go.id/surabayakota/asem_rowo/tambak_sarioso
TPS 6,658,414,81,324,405,9,414,https://pilkada2015.kpu.go.id/surabayakota/asem_rowo/tambak_sarioso
TPS 7,456,261,31,223,254,7,261,https://pilkada2015.kpu.go.id/surabayakota/asem_rowo/tambak_sarioso
TPS 8,598,387,53,324,377,10,387,https://pilkada2015.kpu.go.id/surabayakota/asem_rowo/tambak_sarioso
TPS 9,471,293,48,239,287,6,293,https://pilkada2015.kpu.go.id/surabayakota/asem_rowo/tambak_sarioso
TPS 1,531,290,39,248,287,3,290,https://pilkada2015.kpu.go.id/surabayakota/benowo/kandangan
TPS 2,518,276,45,230,275,1,276,https://pilkada2015.kpu.go.id/surabayakota/benowo/kandangan
TPS 3,533,340,31,307,338,2,340,https://pilkada2015.kpu.go.id/surabayakota/benowo/kandangan
TPS 4,641,375,81,290,0,0,0,https://pilkada2015.kpu.go.id/surabayakota/benowo/kandangan
TPS 5,609,362,46,309,355,7,362,https://pilkada2015.kpu.go.id/surabayakota/benowo/kandangan
TPS 6,612,362,54,303,357,5,362,https://pilkada2015.kpu.go.id/surabayakota/benowo/kandangan
TPS 7,453,287,28,256,284,3,287,https://pilkada2015.kpu.go.id/surabayakota/benowo/kandangan
TPS 8,585,345,53,283,336,9,345,https://pilkada2015.kpu.go.id/surabayakota/benowo/kandangan
TPS 9,257,260,15,241,256,4,260,https://pilkada2015.kpu.go.id/surabayakota/benowo/kandangan
TPS 10,595,349,54,284,338,11,349,https://pilkada2015.kpu.go.id/surabayakota/benowo/kandangan
TPS 11,521,301,47,247,294,7,301,https://pilkada2015.kpu.go.id/surabayakota/benowo/kandangan
TPS 12,672,395,40,348,388,7,395,https://pilkada2015.kpu.go.id/surabayakota/benowo/kandangan
TPS 13,563,334,56,271,327,7,334,https://pilkada2015.kpu.go.id/surabayakota/benowo/kandangan
TPS 14,564,275,33,237,270,5,275,https://pilkada2015.kpu.go.id/surabayakota/benowo/kandangan
TPS 15,583,286,38,246,284,2,286,https://pilkada2015.kpu.go.id/surabayakota/benowo/kandangan
TPS 16,694,458,49,404,453,5,458,https://pilkada2015.kpu.go.id/surabayakota/benowo/kandangan
TPS 17,533,293,50,240,290,3,293,https://pilkada2015.kpu.go.id/surabayakota/benowo/kandangan
TPS 18,490,275,38,237,275,0,275,https://pilkada2015.kpu.go.id/surabayakota/benowo/kandangan
TPS 19,448,263,57,205,262,1,263,https://pilkada2015.kpu.go.id/surabayakota/benowo/kandangan
TPS 20,470,271,41,225,266,5,271,https://pilkada2015.kpu.go.id/surabayakota/benowo/kandangan
TPS 21,438,244,46,192,238,6,244,https://pilkada2015.kpu.go.id/surabayakota/benowo/kandangan
TPS 22,486,248,53,193,246,2,248,https://pilkada2015.kpu.go.id/surabayakota/benowo/kandangan
TPS 23,592,262,27,234,261,1,262,https://pilkada2015.kpu.go.id/surabayakota/benowo/kandangan
TPS 24,609,310,75,230,305,5,310,https://pilkada2015.kpu.go.id/surabayakota/benowo/kandangan
TPS 25,353,353,79,271,350,3,353,https://pilkada2015.kpu.go.id/surabayakota/benowo/kandangan
TPS 26,706,362,113,239,352,10,362,https://pilkada2015.kpu.go.id/surabayakota/benowo/kandangan
TPS 1,773,490,51,430,481,9,490,https://pilkada2015.kpu.go.id/surabayakota/benowo/romokalisari
TPS 2,609,384,49,332,381,3,384,https://pilkada2015.kpu.go.id/surabayakota/benowo/romokalisari
TPS 3,246,199,8,186,194,5,199,https://pilkada2015.kpu.go.id/surabayakota/benowo/romokalisari
TPS 1,299,155,33,117,150,5,155,https://pilkada2015.kpu.go.id/surabayakota/benowo/sememi
TPS 2,402,259,36,220,256,3,259,https://pilkada2015.kpu.go.id/surabayakota/benowo/sememi
TPS 3,368,250,19,228,247,3,250,https://pilkada2015.kpu.go.id/surabayakota/benowo/sememi
TPS 4,539,302,76,217,293,9,302,https://pilkada2015.kpu.go.id/surabayakota/benowo/sememi
TPS 5,637,346,37,305,342,4,346,https://pilkada2015.kpu.go.id/surabayakota/benowo/sememi
TPS 6,674,278,25,252,277,1,278,https://pilkada2015.kpu.go.id/surabayakota/benowo/sememi
TPS 7,801,466,51,403,454,12,466,https://pilkada2015.kpu.go.id/surabayakota/benowo/sememi
TPS 8,440,334,33,298,331,3,334,https://pilkada2015.kpu.go.id/surabayakota/benowo/sememi
TPS 9,665,422,55,358,413,9,422,https://pilkada2015.kpu.go.id/surabayakota/benowo/sememi
TPS 10,652,363,32,324,356,7,363,https://pilkada2015.kpu.go.id/surabayakota/benowo/sememi
TPS 11,290,173,31,139,170,3,173,https://pilkada2015.kpu.go.id/surabayakota/benowo/sememi
TPS 12,623,369,35,330,365,4,369,https://pilkada2015.kpu.go.id/surabayakota/benowo/sememi
TPS 13,642,373,19,353,372,1,373,https://pilkada2015.kpu.go.id/surabayakota/benowo/sememi
TPS 14,633,386,37,339,376,10,386,https://pilkada2015.kpu.go.id/surabayakota/benowo/sememi
TPS 15,668,442,52,382,434,8,442,https://pilkada2015.kpu.go.id/surabayakota/benowo/sememi
TPS 16,624,327,49,275,324,3,327,https://pilkada2015.kpu.go.id/surabayakota/benowo/sememi
TPS 17,657,421,35,381,416,5,421,https://pilkada2015.kpu.go.id/surabayakota/benowo/sememi
TPS 18,657,426,42,380,422,4,426,https://pilkada2015.kpu.go.id/surabayakota/benowo/sememi
TPS 19,557,324,22,295,317,7,324,https://pilkada2015.kpu.go.id/surabayakota/benowo/sememi
TPS 20,205,205,32,171,203,2,205,https://pilkada2015.kpu.go.id/surabayakota/benowo/sememi
TPS 21,551,260,30,225,255,5,260,https://pilkada2015.kpu.go.id/surabayakota/benowo/sememi
TPS 22,379,210,24,176,200,10,210,https://pilkada2015.kpu.go.id/surabayakota/benowo/sememi
TPS 23,762,306,27,275,302,4,306,https://pilkada2015.kpu.go.id/surabayakota/benowo/sememi
TPS 24,338,201,21,176,197,4,201,https://pilkada2015.kpu.go.id/surabayakota/benowo/sememi
TPS 25,543,266,25,238,263,3,266,https://pilkada2015.kpu.go.id/surabayakota/benowo/sememi
TPS 26,728,412,52,345,397,15,412,https://pilkada2015.kpu.go.id/surabayakota/benowo/sememi
TPS 27,516,321,54,263,317,4,321,https://pilkada2015.kpu.go.id/surabayakota/benowo/sememi
TPS 28,375,375,44,323,367,8,375,https://pilkada2015.kpu.go.id/surabayakota/benowo/sememi
TPS 29,636,313,48,253,301,12,313,https://pilkada2015.kpu.go.id/surabayakota/benowo/sememi
TPS 30,474,310,77,229,306,4,310,https://pilkada2015.kpu.go.id/surabayakota/benowo/sememi
TPS 31,436,297,35,253,288,9,297,https://pilkada2015.kpu.go.id/surabayakota/benowo/sememi
TPS 32,511,345,52,293,345,0,345,https://pilkada2015.kpu.go.id/surabayakota/benowo/sememi
TPS 33,450,233,33,198,231,2,233,https://pilkada2015.kpu.go.id/surabayakota/benowo/sememi
TPS 34,373,217,20,194,214,3,217,https://pilkada2015.kpu.go.id/surabayakota/benowo/sememi
TPS 35,507,283,46,235,281,2,283,https://pilkada2015.kpu.go.id/surabayakota/benowo/sememi
TPS 36,343,218,15,199,214,4,218,https://pilkada2015.kpu.go.id/surabayakota/benowo/sememi
TPS 37,339,228,13,214,227,1,228,https://pilkada2015.kpu.go.id/surabayakota/benowo/sememi
TPS 38,466,300,30,269,299,1,300,https://pilkada2015.kpu.go.id/surabayakota/benowo/sememi
TPS 39,583,354,34,314,348,6,354,https://pilkada2015.kpu.go.id/surabayakota/benowo/sememi
TPS 40,558,346,22,317,339,7,346,https://pilkada2015.kpu.go.id/surabayakota/benowo/sememi
TPS 1,549,271,22,243,265,6,271,https://pilkada2015.kpu.go.id/surabayakota/benowo/tambak_osowilangun
TPS 2,0,295,54,232,286,9,295,https://pilkada2015.kpu.go.id/surabayakota/benowo/tambak_osowilangun
TPS 3,505,238,29,204,233,5,238,https://pilkada2015.kpu.go.id/surabayakota/benowo/tambak_osowilangun
TPS 4,511,235,30,200,230,5,235,https://pilkada2015.kpu.go.id/surabayakota/benowo/tambak_osowilangun
TPS 5,619,356,66,283,349,7,356,https://pilkada2015.kpu.go.id/surabayakota/benowo/tambak_osowilangun
TPS 1,561,248,40,201,241,7,248,https://pilkada2015.kpu.go.id/surabayakota/bubutan/alun-alun_contong
TPS 2,609,208,30,171,201,7,208,https://pilkada2015.kpu.go.id/surabayakota/bubutan/alun-alun_contong
TPS 3,691,312,26,283,309,3,312,https://pilkada2015.kpu.go.id/surabayakota/bubutan/alun-alun_contong
TPS 4,625,265,34,222,256,9,265,https://pilkada2015.kpu.go.id/surabayakota/bubutan/alun-alun_contong
TPS 5,626,248,23,222,245,3,248,https://pilkada2015.kpu.go.id/surabayakota/bubutan/alun-alun_contong
TPS 6,625,272,28,241,269,3,272,https://pilkada2015.kpu.go.id/surabayakota/bubutan/alun-alun_contong
TPS 7,659,249,23,216,239,10,249,https://pilkada2015.kpu.go.id/surabayakota/bubutan/alun-alun_contong
TPS 8,502,191,10,181,191,0,191,https://pilkada2015.kpu.go.id/surabayakota/bubutan/alun-alun_contong
TPS 9,496,241,31,207,238,3,241,https://pilkada2015.kpu.go.id/surabayakota/bubutan/alun-alun_contong
TPS 10,515,252,62,184,246,6,252,https://pilkada2015.kpu.go.id/surabayakota/bubutan/alun-alun_contong
TPS 1,534,252,19,231,250,2,252,https://pilkada2015.kpu.go.id/surabayakota/bubutan/bubutan
TPS 2,543,294,47,241,288,6,294,https://pilkada2015.kpu.go.id/surabayakota/bubutan/bubutan
TPS 3,542,261,27,228,255,6,261,https://pilkada2015.kpu.go.id/surabayakota/bubutan/bubutan
TPS 4,619,361,40,316,356,5,361,https://pilkada2015.kpu.go.id/surabayakota/bubutan/bubutan
TPS 5,590,329,46,277,323,6,329,https://pilkada2015.kpu.go.id/surabayakota/bubutan/bubutan
TPS 6,623,241,29,205,234,7,241,https://pilkada2015.kpu.go.id/surabayakota/bubutan/bubutan
TPS 7,596,302,38,257,295,7,302,https://pilkada2015.kpu.go.id/surabayakota/bubutan/bubutan
TPS 8,555,268,34,231,265,3,268,https://pilkada2015.kpu.go.id/surabayakota/bubutan/bubutan
TPS 9,626,235,28,206,234,1,235,https://pilkada2015.kpu.go.id/surabayakota/bubutan/bubutan
TPS 10,558,257,57,193,250,7,257,https://pilkada2015.kpu.go.id/surabayakota/bubutan/bubutan
TPS 11,394,198,66,127,193,5,198,https://pilkada2015.kpu.go.id/surabayakota/bubutan/bubutan
TPS 12,473,149,18,126,144,5,149,https://pilkada2015.kpu.go.id/surabayakota/bubutan/bubutan
TPS 13,354,164,22,141,163,1,164,https://pilkada2015.kpu.go.id/surabayakota/bubutan/bubutan
TPS 14,373,205,24,177,201,4,205,https://pilkada2015.kpu.go.id/surabayakota/bubutan/bubutan
TPS 15,498,257,32,221,253,4,257,https://pilkada2015.kpu.go.id/surabayakota/bubutan/bubutan
TPS 16,523,285,41,240,281,4,285,https://pilkada2015.kpu.go.id/surabayakota/bubutan/bubutan
TPS 17,679,285,25,258,283,2,285,https://pilkada2015.kpu.go.id/surabayakota/bubutan/bubutan
TPS 18,478,252,98,148,246,6,252,https://pilkada2015.kpu.go.id/surabayakota/bubutan/bubutan
TPS 19,475,207,107,95,202,5,207,https://pilkada2015.kpu.go.id/surabayakota/bubutan/bubutan
TPS 20,538,322,35,278,313,9,322,https://pilkada2015.kpu.go.id/surabayakota/bubutan/bubutan
TPS 1,529,262,99,158,257,5,262,https://pilkada2015.kpu.go.id/surabayakota/bubutan/gundih
TPS 2,556,244,94,143,237,7,244,https://pilkada2015.kpu.go.id/surabayakota/bubutan/gundih
TPS 3,492,231,43,184,227,4,231,https://pilkada2015.kpu.go.id/surabayakota/bubutan/gundih
TPS 4,457,0,37,184,221,5,226,https://pilkada2015.kpu.go.id/surabayakota/bubutan/gundih
TPS 5,451,194,24,170,194,0,194,https://pilkada2015.kpu.go.id/surabayakota/bubutan/gundih
TPS 6,367,184,22,157,179,5,184,https://pilkada2015.kpu.go.id/surabayakota/bubutan/gundih
TPS 7,495,209,55,151,206,3,209,https://pilkada2015.kpu.go.id/surabayakota/bubutan/gundih
TPS 8,502,274,36,237,273,1,274,https://pilkada2015.kpu.go.id/surabayakota/bubutan/gundih
TPS 9,280,121,19,100,119,2,121,https://pilkada2015.kpu.go.id/surabayakota/bubutan/gundih
TPS 10,361,159,20,135,155,4,159,https://pilkada2015.kpu.go.id/surabayakota/bubutan/gundih
TPS 11,558,275,31,240,271,4,275,https://pilkada2015.kpu.go.id/surabayakota/bubutan/gundih
TPS 12,426,227,38,188,226,1,227,https://pilkada2015.kpu.go.id/surabayakota/bubutan/gundih
TPS 13,561,257,33,221,254,3,257,https://pilkada2015.kpu.go.id/surabayakota/bubutan/gundih
TPS 14,533,296,18,273,291,5,296,https://pilkada2015.kpu.go.id/surabayakota/bubutan/gundih
TPS 15,504,333,46,280,326,7,333,https://pilkada2015.kpu.go.id/surabayakota/bubutan/gundih
TPS 16,569,295,53,237,290,5,295,https://pilkada2015.kpu.go.id/surabayakota/bubutan/gundih
TPS 17,518,201,22,176,198,3,201,https://pilkada2015.kpu.go.id/surabayakota/bubutan/gundih
TPS 18,532,173,26,144,170,3,173,https://pilkada2015.kpu.go.id/surabayakota/bubutan/gundih
TPS 19,525,263,33,221,254,9,263,https://pilkada2015.kpu.go.id/surabayakota/bubutan/gundih
TPS 20,0,0,0,0,0,0,0,https://pilkada2015.kpu.go.id/surabayakota/bubutan/gundih
TPS 21,542,258,33,223,256,2,258,https://pilkada2015.kpu.go.id/surabayakota/bubutan/gundih
TPS 22,546,220,35,182,217,3,220,https://pilkada2015.kpu.go.id/surabayakota/bubutan/gundih
TPS 23,477,241,35,200,235,6,241,https://pilkada2015.kpu.go.id/surabayakota/bubutan/gundih
TPS 24,604,239,40,197,237,2,239,https://pilkada2015.kpu.go.id/surabayakota/bubutan/gundih
TPS 25,0,0,0,0,0,0,0,https://pilkada2015.kpu.go.id/surabayakota/bubutan/gundih
TPS 26,421,262,29,228,257,5,262,https://pilkada2015.kpu.go.id/surabayakota/bubutan/gundih
TPS 27,550,235,22,211,233,2,235,https://pilkada2015.kpu.go.id/surabayakota/bubutan/gundih
TPS 28,535,198,21,176,197,1,198,https://pilkada2015.kpu.go.id/surabayakota/bubutan/gundih
TPS 29,522,250,40,206,246,4,250,https://pilkada2015.kpu.go.id/surabayakota/bubutan/gundih
TPS 30,513,185,26,157,183,2,185,https://pilkada2015.kpu.go.id/surabayakota/bubutan/gundih
TPS 31,0,174,14,160,14,160,174,https://pilkada2015.kpu.go.id/surabayakota/bubutan/gundih
TPS 32,529,238,30,202,232,6,238,https://pilkada2015.kpu.go.id/surabayakota/bubutan/gundih
TPS 33,0,0,0,0,0,0,0,https://pilkada2015.kpu.go.id/surabayakota/bubutan/gundih
TPS 34,520,240,34,203,237,3,240,https://pilkada2015.kpu.go.id/surabayakota/bubutan/gundih
TPS 35,507,178,22,148,170,8,178,https://pilkada2015.kpu.go.id/surabayakota/bubutan/gundih
TPS 36,501,222,43,176,219,3,222,https://pilkada2015.kpu.go.id/surabayakota/bubutan/gundih
TPS 37,493,226,28,194,222,4,226,https://pilkada2015.kpu.go.id/surabayakota/bubutan/gundih
TPS 38,489,217,35,177,212,5,217,https://pilkada2015.kpu.go.id/surabayakota/bubutan/gundih
TPS 39,564,344,43,293,336,8,344,https://pilkada2015.kpu.go.id/surabayakota/bubutan/gundih
TPS 40,601,325,34,288,322,3,325,https://pilkada2015.kpu.go.id/surabayakota/bubutan/gundih
TPS 41,616,243,33,204,237,6,243,https://pilkada2015.kpu.go.id/surabayakota/bubutan/gundih
TPS 1,454,248,35,209,244,4,248,https://pilkada2015.kpu.go.id/surabayakota/bubutan/jepara
TPS 2,420,232,21,210,231,1,232,https://pilkada2015.kpu.go.id/surabayakota/bubutan/jepara
TPS 3,467,267,34,230,264,3,267,https://pilkada2015.kpu.go.id/surabayakota/bubutan/jepara
TPS 4,276,166,24,139,163,3,166,https://pilkada2015.kpu.go.id/surabayakota/bubutan/jepara
TPS 5,530,294,56,232,288,6,294,https://pilkada2015.kpu.go.id/surabayakota/bubutan/jepara
TPS 6,511,264,36,222,258,6,264,https://pilkada2015.kpu.go.id/surabayakota/bubutan/jepara
TPS 7,531,237,38,188,226,11,237,https://pilkada2015.kpu.go.id/surabayakota/bubutan/jepara
TPS 8,467,311,0,0,306,5,311,https://pilkada2015.kpu.go.id/surabayakota/bubutan/jepara
TPS 9,648,278,28,240,268,10,278,https://pilkada2015.kpu.go.id/surabayakota/bubutan/jepara
TPS 10,561,266,50,215,265,1,266,https://pilkada2015.kpu.go.id/surabayakota/bubutan/jepara
TPS 11,644,388,39,340,379,9,388,https://pilkada2015.kpu.go.id/surabayakota/bubutan/jepara
TPS 12,387,213,26,177,203,10,213,https://pilkada2015.kpu.go.id/surabayakota/bubutan/jepara
TPS 13,399,222,32,187,219,3,222,https://pilkada2015.kpu.go.id/surabayakota/bubutan/jepara
TPS 14,440,264,26,235,261,3,264,https://pilkada2015.kpu.go.id/surabayakota/bubutan/jepara
TPS 15,468,248,33,214,247,1,248,https://pilkada2015.kpu.go.id/surabayakota/bubutan/jepara
TPS 16,454,265,38,225,263,2,265,https://pilkada2015.kpu.go.id/surabayakota/bubutan/jepara
TPS 17,480,257,32,224,256,1,257,https://pilkada2015.kpu.go.id/surabayakota/bubutan/jepara
TPS 18,431,198,39,156,195,3,198,https://pilkada2015.kpu.go.id/surabayakota/bubutan/jepara
TPS 19,575,311,72,234,306,5,311,https://pilkada2015.kpu.go.id/surabayakota/bubutan/jepara
TPS 20,436,250,40,208,248,2,250,https://pilkada2015.kpu.go.id/surabayakota/bubutan/jepara
TPS 21,408,227,29,190,219,8,227,https://pilkada2015.kpu.go.id/surabayakota/bubutan/jepara
TPS 22,456,253,29,223,252,1,253,https://pilkada2015.kpu.go.id/surabayakota/bubutan/jepara
TPS 23,477,241,35,200,235,6,241,https://pilkada2015.kpu.go.id/surabayakota/bubutan/jepara
TPS 24,357,171,21,149,170,1,171,https://pilkada2015.kpu.go.id/surabayakota/bubutan/jepara
TPS 25,466,277,28,244,272,5,277,https://pilkada2015.kpu.go.id/surabayakota/bubutan/jepara
TPS 26,365,235,37,190,227,8,235,https://pilkada2015.kpu.go.id/surabayakota/bubutan/jepara
TPS 27,295,200,35,163,198,2,200,https://pilkada2015.kpu.go.id/surabayakota/bubutan/jepara
TPS 28,406,214,45,160,205,9,214,https://pilkada2015.kpu.go.id/surabayakota/bubutan/jepara
TPS 29,573,298,39,252,291,7,298,https://pilkada2015.kpu.go.id/surabayakota/bubutan/jepara
TPS 30,664,253,65,183,250,3,253,https://pilkada2015.kpu.go.id/surabayakota/bubutan/jepara
TPS 31,552,277,36,238,274,3,277,https://pilkada2015.kpu.go.id/surabayakota/bubutan/jepara
TPS 32,681,284,32,245,277,7,284,https://pilkada2015.kpu.go.id/surabayakota/bubutan/jepara
TPS 33,433,171,34,131,165,6,171,https://pilkada2015.kpu.go.id/surabayakota/bubutan/jepara
TPS 34,583,255,69,176,245,10,255,https://pilkada2015.kpu.go.id/surabayakota/bubutan/jepara
TPS 35,743,321,33,286,319,2,321,https://pilkada2015.kpu.go.id/surabayakota/bubutan/jepara
TPS 36,654,368,29,324,353,15,368,https://pilkada2015.kpu.go.id/surabayakota/bubutan/jepara
TPS 1,358,141,20,117,137,4,141,https://pilkada2015.kpu.go.id/surabayakota/bubutan/tembok_dukuh
TPS 2,536,242,49,190,239,3,242,https://pilkada2015.kpu.go.id/surabayakota/bubutan/tembok_dukuh
TPS 3,541,283,51,230,281,2,283,https://pilkada2015.kpu.go.id/surabayakota/bubutan/tembok_dukuh
TPS 4,645,294,28,263,291,3,294,https://pilkada2015.kpu.go.id/surabayakota/bubutan/tembok_dukuh
TPS 5,611,326,53,270,323,3,326,https://pilkada2015.kpu.go.id/surabayakota/bubutan/tembok_dukuh
TPS 6,631,318,39,274,313,5,318,https://pilkada2015.kpu.go.id/surabayakota/bubutan/tembok_dukuh
TPS 7,609,354,40,307,347,7,354,https://pilkada2015.kpu.go.id/surabayakota/bubutan/tembok_dukuh
TPS 8,418,236,38,194,232,4,236,https://pilkada2015.kpu.go.id/surabayakota/bubutan/tembok_dukuh
TPS 9,435,245,42,198,240,5,245,https://pilkada2015.kpu.go.id/surabayakota/bubutan/tembok_dukuh
TPS 10,465,299,46,247,293,6,299,https://pilkada2015.kpu.go.id/surabayakota/bubutan/tembok_dukuh
TPS 11,555,333,69,254,323,10,333,https://pilkada2015.kpu.go.id/surabayakota/bubutan/tembok_dukuh
TPS 12,521,334,30,301,331,3,334,https://pilkada2015.kpu.go.id/surabayakota/bubutan/tembok_dukuh
TPS 13,341,201,24,172,196,5,201,https://pilkada2015.kpu.go.id/surabayakota/bubutan/tembok_dukuh
TPS 14,406,239,31,205,236,3,239,https://pilkada2015.kpu.go.id/surabayakota/bubutan/tembok_dukuh
TPS 15,545,311,38,269,307,4,311,https://pilkada2015.kpu.go.id/surabayakota/bubutan/tembok_dukuh
TPS 16,403,280,38,240,278,2,280,https://pilkada2015.kpu.go.id/surabayakota/bubutan/tembok_dukuh
TPS 17,514,296,34,255,289,7,296,https://pilkada2015.kpu.go.id/surabayakota/bubutan/tembok_dukuh
TPS 18,466,312,50,255,305,7,312,https://pilkada2015.kpu.go.id/surabayakota/bubutan/tembok_dukuh
TPS 19,482,310,30,274,304,6,310,https://pilkada2015.kpu.go.id/surabayakota/bubutan/tembok_dukuh
TPS 20,443,256,38,218,256,0,256,https://pilkada2015.kpu.go.id/surabayakota/bubutan/tembok_dukuh
TPS 21,532,266,25,237,262,4,266,https://pilkada2015.kpu.go.id/surabayakota/bubutan/tembok_dukuh
TPS 22,588,350,39,303,342,8,350,https://pilkada2015.kpu.go.id/surabayakota/bubutan/tembok_dukuh
TPS 23,585,316,52,257,309,7,316,https://pilkada2015.kpu.go.id/surabayakota/bubutan/tembok_dukuh
TPS 24,481,258,42,208,250,8,258,https://pilkada2015.kpu.go.id/surabayakota/bubutan/tembok_dukuh
TPS 25,486,283,31,248,279,4,283,https://pilkada2015.kpu.go.id/surabayakota/bubutan/tembok_dukuh
TPS 26,481,234,55,172,227,7,234,https://pilkada2015.kpu.go.id/surabayakota/bubutan/tembok_dukuh
TPS 27,541,232,47,183,230,2,232,https://pilkada2015.kpu.go.id/surabayakota/bubutan/tembok_dukuh
TPS 28,460,253,50,190,240,13,253,https://pilkada2015.kpu.go.id/surabayakota/bubutan/tembok_dukuh
TPS 29,346,185,36,149,185,0,185,https://pilkada2015.kpu.go.id/surabayakota/bubutan/tembok_dukuh
TPS 30,449,263,38,219,257,6,263,https://pilkada2015.kpu.go.id/surabayakota/bubutan/tembok_dukuh
TPS 31,516,292,38,246,284,8,292,https://pilkada2015.kpu.go.id/surabayakota/bubutan/tembok_dukuh
TPS 32,556,275,35,231,266,9,275,https://pilkada2015.kpu.go.id/surabayakota/bubutan/tembok_dukuh
TPS 33,507,308,35,270,305,3,308,https://pilkada2015.kpu.go.id/surabayakota/bubutan/tembok_dukuh
TPS 34,445,193,32,157,189,4,193,https://pilkada2015.kpu.go.id/surabayakota/bubutan/tembok_dukuh
TPS 35,516,305,35,264,299,6,305,https://pilkada2015.kpu.go.id/surabayakota/bubutan/tembok_dukuh
TPS 36,487,340,35,290,325,15,340,https://pilkada2015.kpu.go.id/surabayakota/bubutan/tembok_dukuh
TPS 37,440,283,47,221,268,15,283,https://pilkada2015.kpu.go.id/surabayakota/bubutan/tembok_dukuh
TPS 1,167,92,18,74,92,0,92,https://pilkada2015.kpu.go.id/surabayakota/bulak/bulak
TPS 2,611,306,29,275,304,2,306,https://pilkada2015.kpu.go.id/surabayakota/bulak/bulak
TPS 3,593,313,29,281,310,3,313,https://pilkada2015.kpu.go.id/surabayakota/bulak/bulak
TPS 4,609,299,14,281,295,4,299,https://pilkada2015.kpu.go.id/surabayakota/bulak/bulak
TPS 5,525,315,26,283,309,6,315,https://pilkada2015.kpu.go.id/surabayakota/bulak/bulak
TPS 6,636,389,43,339,382,7,389,https://pilkada2015.kpu.go.id/surabayakota/bulak/bulak
TPS 7,578,338,27,303,330,8,338,https://pilkada2015.kpu.go.id/surabayakota/bulak/bulak
TPS 8,487,314,14,296,310,4,314,https://pilkada2015.kpu.go.id/surabayakota/bulak/bulak
TPS 9,522,286,20,258,278,8,286,https://pilkada2015.kpu.go.id/surabayakota/bulak/bulak
TPS 10,598,319,35,280,315,4,319,https://pilkada2015.kpu.go.id/surabayakota/bulak/bulak
TPS 11,504,297,28,261,289,8,297,https://pilkada2015.kpu.go.id/surabayakota/bulak/bulak
TPS 12,542,347,40,302,342,5,347,https://pilkada2015.kpu.go.id/surabayakota/bulak/bulak
TPS 13,568,374,28,338,366,8,374,https://pilkada2015.kpu.go.id/surabayakota/bulak/bulak
TPS 14,599,382,37,338,375,7,382,https://pilkada2015.kpu.go.id/surabayakota/bulak/bulak
TPS 15,567,326,43,282,325,1,326,https://pilkada2015.kpu.go.id/surabayakota/bulak/bulak
TPS 16,492,305,37,266,303,2,305,https://pilkada2015.kpu.go.id/surabayakota/bulak/bulak
TPS 17,474,266,39,220,259,7,266,https://pilkada2015.kpu.go.id/surabayakota/bulak/bulak
TPS 18,497,289,42,246,288,1,289,https://pilkada2015.kpu.go.id/surabayakota/bulak/bulak
TPS 19,485,485,23,288,311,4,315,https://pilkada2015.kpu.go.id/surabayakota/bulak/bulak
TPS 20,766,455,35,414,449,6,455,https://pilkada2015.kpu.go.id/surabayakota/bulak/bulak
TPS 21,742,424,66,352,418,6,424,https://pilkada2015.kpu.go.id/surabayakota/bulak/bulak
TPS 22,783,444,43,396,439,5,444,https://pilkada2015.kpu.go.id/surabayakota/bulak/bulak
TPS 23,404,232,18,212,230,2,232,https://pilkada2015.kpu.go.id/surabayakota/bulak/bulak
TPS 24,445,197,51,138,189,7,196,https://pilkada2015.kpu.go.id/surabayakota/bulak/bulak
TPS 1,440,201,25,173,198,3,201,https://pilkada2015.kpu.go.id/surabayakota/bulak/kedung_cowek
TPS 2,445,222,22,198,220,2,222,https://pilkada2015.kpu.go.id/surabayakota/bulak/kedung_cowek
TPS 3,462,246,28,210,238,8,246,https://pilkada2015.kpu.go.id/surabayakota/bulak/kedung_cowek
TPS 4,642,231,22,202,224,7,231,https://pilkada2015.kpu.go.id/surabayakota/bulak/kedung_cowek
TPS 5,572,194,35,154,189,5,194,https://pilkada2015.kpu.go.id/surabayakota/bulak/kedung_cowek
TPS 6,580,253,33,216,249,4,253,https://pilkada2015.kpu.go.id/surabayakota/bulak/kedung_cowek
TPS 7,575,235,49,175,224,11,235,https://pilkada2015.kpu.go.id/surabayakota/bulak/kedung_cowek
TPS 1,0,149,26,120,146,3,149,https://pilkada2015.kpu.go.id/surabayakota/bulak/kenjeran
TPS 2,532,222,73,143,216,6,222,https://pilkada2015.kpu.go.id/surabayakota/bulak/kenjeran
TPS 3,558,269,99,170,269,0,269,https://pilkada2015.kpu.go.id/surabayakota/bulak/kenjeran
TPS 4,737,348,177,166,343,5,348,https://pilkada2015.kpu.go.id/surabayakota/bulak/kenjeran
TPS 5,454,281,43,229,272,9,281,https://pilkada2015.kpu.go.id/surabayakota/bulak/kenjeran
TPS 6,284,171,22,146,168,3,171,https://pilkada2015.kpu.go.id/surabayakota/bulak/kenjeran
TPS 7,602,262,22,240,262,0,262,https://pilkada2015.kpu.go.id/surabayakota/bulak/kenjeran
TPS 8,618,254,11,243,254,0,254,https://pilkada2015.kpu.go.id/surabayakota/bulak/kenjeran
TPS 1,593,248,46,193,239,9,248,https://pilkada2015.kpu.go.id/surabayakota/bulak/sukolilo_baru
TPS 2,598,240,63,169,232,8,240,https://pilkada2015.kpu.go.id/surabayakota/bulak/sukolilo_baru
TPS 3,568,280,143,122,265,15,280,https://pilkada2015.kpu.go.id/surabayakota/bulak/sukolilo_baru
TPS 4,579,258,103,140,243,15,258,https://pilkada2015.kpu.go.id/surabayakota/bulak/sukolilo_baru
TPS 5,564,256,59,186,245,11,256,https://pilkada2015.kpu.go.id/surabayakota/bulak/sukolilo_baru
TPS 6,588,229,76,144,220,9,229,https://pilkada2015.kpu.go.id/surabayakota/bulak/sukolilo_baru
TPS 7,586,321,35,282,317,4,321,https://pilkada2015.kpu.go.id/surabayakota/bulak/sukolilo_baru
TPS 8,603,292,30,261,291,1,292,https://pilkada2015.kpu.go.id/surabayakota/bulak/sukolilo_baru
TPS 9,520,315,24,289,313,2,315,https://pilkada2015.kpu.go.id/surabayakota/bulak/sukolilo_baru
TPS 10,454,280,36,242,278,2,280,https://pilkada2015.kpu.go.id/surabayakota/bulak/sukolilo_baru
TPS 11,398,234,24,210,234,0,234,https://pilkada2015.kpu.go.id/surabayakota/bulak/sukolilo_baru
TPS 12,402,245,17,224,241,4,245,https://pilkada2015.kpu.go.id/surabayakota/bulak/sukolilo_baru
TPS 13,361,228,37,188,225,3,228,https://pilkada2015.kpu.go.id/surabayakota/bulak/sukolilo_baru
TPS 1,407,198,17,179,196,2,198,https://pilkada2015.kpu.go.id/surabayakota/dukuhpakis/dukuh_kupang
TPS 2,395,250,28,217,245,5,250,https://pilkada2015.kpu.go.id/surabayakota/dukuhpakis/dukuh_kupang
TPS 3,493,237,14,218,232,5,237,https://pilkada2015.kpu.go.id/surabayakota/dukuhpakis/dukuh_kupang
TPS 4,614,358,48,306,354,4,358,https://pilkada2015.kpu.go.id/surabayakota/dukuhpakis/dukuh_kupang
TPS 5,355,187,11,176,187,0,87,https://pilkada2015.kpu.go.id/surabayakota/dukuhpakis/dukuh_kupang
TPS 6,433,220,40,177,217,3,220,https://pilkada2015.kpu.go.id/surabayakota/dukuhpakis/dukuh_kupang
TPS 7,501,257,41,215,256,1,257,https://pilkada2015.kpu.go.id/surabayakota/dukuhpakis/dukuh_kupang
TPS 8,478,239,44,193,237,2,239,https://pilkada2015.kpu.go.id/surabayakota/dukuhpakis/dukuh_kupang
TPS 9,696,314,54,255,309,5,314,https://pilkada2015.kpu.go.id/surabayakota/dukuhpakis/dukuh_kupang
TPS 10,682,280,23,253,276,0,280,https://pilkada2015.kpu.go.id/surabayakota/dukuhpakis/dukuh_kupang
TPS 11,512,214,7,206,213,1,214,https://pilkada2015.kpu.go.id/surabayakota/dukuhpakis/dukuh_kupang
TPS 12,526,248,11,237,248,0,248,https://pilkada2015.kpu.go.id/surabayakota/dukuhpakis/dukuh_kupang
TPS 13,575,305,45,246,291,14,305,https://pilkada2015.kpu.go.id/surabayakota/dukuhpakis/dukuh_kupang
TPS 14,295,176,21,152,173,3,176,https://pilkada2015.kpu.go.id/surabayakota/dukuhpakis/dukuh_kupang
TPS 15,692,385,45,336,381,4,385,https://pilkada2015.kpu.go.id/surabayakota/dukuhpakis/dukuh_kupang
TPS 16,440,219,50,155,205,14,219,https://pilkada2015.kpu.go.id/surabayakota/dukuhpakis/dukuh_kupang
TPS 17,335,116,30,82,112,4,116,https://pilkada2015.kpu.go.id/surabayakota/dukuhpakis/dukuh_kupang
TPS 18,292,148,38,106,144,4,148,https://pilkada2015.kpu.go.id/surabayakota/dukuhpakis/dukuh_kupang
TPS 19,574,235,68,165,233,2,235,https://pilkada2015.kpu.go.id/surabayakota/dukuhpakis/dukuh_kupang
TPS 20,417,247,58,183,241,6,247,https://pilkada2015.kpu.go.id/surabayakota/dukuhpakis/dukuh_kupang
TPS 21,368,189,25,159,184,5,189,https://pilkada2015.kpu.go.id/surabayakota/dukuhpakis/dukuh_kupang
TPS 22,561,270,24,242,266,4,270,https://pilkada2015.kpu.go.id/surabayakota/dukuhpakis/dukuh_kupang
TPS 1,609,213,14,197,211,2,213,https://pilkada2015.kpu.go.id/surabayakota/dukuhpakis/dukuh_pakis
TPS 2,556,302,26,273,299,3,302,https://pilkada2015.kpu.go.id/surabayakota/dukuhpakis/dukuh_pakis
TPS 3,595,368,66,296,362,6,368,https://pilkada2015.kpu.go.id/surabayakota/dukuhpakis/dukuh_pakis
TPS 4,465,281,49,229,278,3,281,https://pilkada2015.kpu.go.id/surabayakota/dukuhpakis/dukuh_pakis
TPS 5,473,345,50,288,338,7,345,https://pilkada2015.kpu.go.id/surabayakota/dukuhpakis/dukuh_pakis
TPS 6,602,358,39,316,355,3,358,https://pilkada2015.kpu.go.id/surabayakota/dukuhpakis/dukuh_pakis
TPS 7,600,399,70,320,390,9,399,https://pilkada2015.kpu.go.id/surabayakota/dukuhpakis/dukuh_pakis
TPS 8,515,326,49,275,324,2,326,https://pilkada2015.kpu.go.id/surabayakota/dukuhpakis/dukuh_pakis
TPS 9,562,167,9,157,166,1,167,https://pilkada2015.kpu.go.id/surabayakota/dukuhpakis/dukuh_pakis
TPS 10,426,181,8,172,180,1,181,https://pilkada2015.kpu.go.id/surabayakota/dukuhpakis/dukuh_pakis
TPS 11,509,256,41,213,254,2,256,https://pilkada2015.kpu.go.id/surabayakota/dukuhpakis/dukuh_pakis
TPS 12,475,228,39,189,228,0,228,https://pilkada2015.kpu.go.id/surabayakota/dukuhpakis/dukuh_pakis
TPS 13,503,244,43,198,241,3,244,https://pilkada2015.kpu.go.id/surabayakota/dukuhpakis/dukuh_pakis
TPS 14,482,239,25,213,238,1,239,https://pilkada2015.kpu.go.id/surabayakota/dukuhpakis/dukuh_pakis
TPS 15,599,240,43,192,235,5,240,https://pilkada2015.kpu.go.id/surabayakota/dukuhpakis/dukuh_pakis
TPS 16,495,287,33,251,284,3,287,https://pilkada2015.kpu.go.id/surabayakota/dukuhpakis/dukuh_pakis
TPS 17,588,334,52,270,322,12,334,https://pilkada2015.kpu.go.id/surabayakota/dukuhpakis/dukuh_pakis
TPS 18,585,290,41,249,290,0,290,https://pilkada2015.kpu.go.id/surabayakota/dukuhpakis/dukuh_pakis
TPS 19,597,329,30,287,317,12,329,https://pilkada2015.kpu.go.id/surabayakota/dukuhpakis/dukuh_pakis
TPS 1,656,237,15,222,237,0,237,https://pilkada2015.kpu.go.id/surabayakota/dukuhpakis/gunung_sari
TPS 2,480,316,41,267,308,8,316,https://pilkada2015.kpu.go.id/surabayakota/dukuhpakis/gunung_sari
TPS 3,461,262,31,225,256,6,262,https://pilkada2015.kpu.go.id/surabayakota/dukuhpakis/gunung_sari
TPS 4,407,233,27,205,232,1,233,https://pilkada2015.kpu.go.id/surabayakota/dukuhpakis/gunung_sari
TPS 5,393,231,29,200,229,2,231,https://pilkada2015.kpu.go.id/surabayakota/dukuhpakis/gunung_sari
TPS 6,751,439,66,368,434,5,439,https://pilkada2015.kpu.go.id/surabayakota/dukuhpakis/gunung_sari
TPS 7,749,447,49,393,442,5,447,https://pilkada2015.kpu.go.id/surabayakota/dukuhpakis/gunung_sari
TPS 8,502,337,48,287,335,2,337,https://pilkada2015.kpu.go.id/surabayakota/dukuhpakis/gunung_sari
TPS 9,480,301,47,252,299,2,301,https://pilkada2015.kpu.go.id/surabayakota/dukuhpakis/gunung_sari
TPS 10,630,391,46,335,381,10,391,https://pilkada2015.kpu.go.id/surabayakota/dukuhpakis/gunung_sari
TPS 11,655,403,56,336,392,11,403,https://pilkada2015.kpu.go.id/surabayakota/dukuhpakis/gunung_sari
TPS 12,405,250,49,197,246,4,250,https://pilkada2015.kpu.go.id/surabayakota/dukuhpakis/gunung_sari
TPS 13,261,141,24,110,134,7,141,https://pilkada2015.kpu.go.id/surabayakota/dukuhpakis/gunung_sari
TPS 14,525,338,41,291,332,6,338,https://pilkada2015.kpu.go.id/surabayakota/dukuhpakis/gunung_sari
TPS 15,353,220,32,183,215,5,220,https://pilkada2015.kpu.go.id/surabayakota/dukuhpakis/gunung_sari
TPS 16,602,206,5,198,203,3,206,https://pilkada2015.kpu.go.id/surabayakota/dukuhpakis/gunung_sari
TPS 17,663,346,27,311,338,8,346,https://pilkada2015.kpu.go.id/surabayakota/dukuhpakis/gunung_sari
TPS 18,413,270,41,227,268,2,270,https://pilkada2015.kpu.go.id/surabayakota/dukuhpakis/gunung_sari
TPS 19,394,173,10,161,171,2,173,https://pilkada2015.kpu.go.id/surabayakota/dukuhpakis/gunung_sari
TPS 1,293,193,19,173,192,1,193,https://pilkada2015.kpu.go.id/surabayakota/dukuhpakis/pradahkalikendal
TPS 2,684,395,32,361,393,2,395,https://pilkada2015.kpu.go.id/surabayakota/dukuhpakis/pradahkalikendal
TPS 3,528,324,36,283,319,5,324,https://pilkada2015.kpu.go.id/surabayakota/dukuhpakis/pradahkalikendal
TPS 4,642,322,29,291,320,2,322,https://pilkada2015.kpu.go.id/surabayakota/dukuhpakis/pradahkalikendal
TPS 5,588,362,31,322,353,9,362,https://pilkada2015.kpu.go.id/surabayakota/dukuhpakis/pradahkalikendal
TPS 6,751,470,102,360,462,8,470,https://pilkada2015.kpu.go.id/surabayakota/dukuhpakis/pradahkalikendal
TPS 7,717,439,43,389,432,7,439,https://pilkada2015.kpu.go.id/surabayakota/dukuhpakis/pradahkalikendal
TPS 8,365,176,32,141,173,3,176,https://pilkada2015.kpu.go.id/surabayakota/dukuhpakis/pradahkalikendal
TPS 9,604,180,8,169,177,3,180,https://pilkada2015.kpu.go.id/surabayakota/dukuhpakis/pradahkalikendal
TPS 10,553,226,19,205,224,2,226,https://pilkada2015.kpu.go.id/surabayakota/dukuhpakis/pradahkalikendal
TPS 11,288,177,25,145,170,7,117,https://pilkada2015.kpu.go.id/surabayakota/dukuhpakis/pradahkalikendal
TPS 12,592,232,6,225,231,1,232,https://pilkada2015.kpu.go.id/surabayakota/dukuhpakis/pradahkalikendal
TPS 13,707,247,16,230,246,1,247,https://pilkada2015.kpu.go.id/surabayakota/dukuhpakis/pradahkalikendal
TPS 14,397,240,20,214,234,6,240,https://pilkada2015.kpu.go.id/surabayakota/dukuhpakis/pradahkalikendal
TPS 15,521,181,15,166,181,0,181,https://pilkada2015.kpu.go.id/surabayakota/dukuhpakis/pradahkalikendal
TPS 16,273,144,5,135,140,4,144,https://pilkada2015.kpu.go.id/surabayakota/dukuhpakis/pradahkalikendal
TPS 17,441,168,6,161,167,1,168,https://pilkada2015.kpu.go.id/surabayakota/dukuhpakis/pradahkalikendal
TPS 18,299,112,6,106,112,0,112,https://pilkada2015.kpu.go.id/surabayakota/dukuhpakis/pradahkalikendal
TPS 19,732,336,21,313,334,2,336,https://pilkada2015.kpu.go.id/surabayakota/dukuhpakis/pradahkalikendal
TPS 20,737,239,12,227,239,0,239,https://pilkada2015.kpu.go.id/surabayakota/dukuhpakis/pradahkalikendal
TPS 21,496,145,11,132,143,2,145,https://pilkada2015.kpu.go.id/surabayakota/dukuhpakis/pradahkalikendal
TPS 22,688,195,12,183,195,0,195,https://pilkada2015.kpu.go.id/surabayakota/dukuhpakis/pradahkalikendal
TPS 1,542,339,34,301,335,4,339,https://pilkada2015.kpu.go.id/surabayakota/gayungan/dukuh_menanggal
TPS 2,727,450,37,407,444,6,450,https://pilkada2015.kpu.go.id/surabayakota/gayungan/dukuh_menanggal
TPS 3,430,291,40,251,291,0,291,https://pilkada2015.kpu.go.id/surabayakota/gayungan/dukuh_menanggal
TPS 4,458,254,25,226,251,3,254,https://pilkada2015.kpu.go.id/surabayakota/gayungan/dukuh_menanggal
TPS 5,437,280,34,243,277,3,280,https://pilkada2015.kpu.go.id/surabayakota/gayungan/dukuh_menanggal
TPS 6,690,414,27,382,409,5,414,https://pilkada2015.kpu.go.id/surabayakota/gayungan/dukuh_menanggal
TPS 7,544,319,28,289,317,2,319,https://pilkada2015.kpu.go.id/surabayakota/gayungan/dukuh_menanggal
TPS 8,402,277,75,201,276,1,277,https://pilkada2015.kpu.go.id/surabayakota/gayungan/dukuh_menanggal
TPS 9,428,265,40,224,264,1,265,https://pilkada2015.kpu.go.id/surabayakota/gayungan/dukuh_menanggal
TPS 10,684,397,50,345,395,2,397,https://pilkada2015.kpu.go.id/surabayakota/gayungan/dukuh_menanggal
TPS 11,283,121,28,91,119,2,121,https://pilkada2015.kpu.go.id/surabayakota/gayungan/dukuh_menanggal
TPS 1,558,379,69,303,372,7,379,https://pilkada2015.kpu.go.id/surabayakota/gayungan/gayungan
TPS 2,615,418,93,324,417,1,418,https://pilkada2015.kpu.go.id/surabayakota/gayungan/gayungan
TPS 3,483,307,28,278,306,1,307,https://pilkada2015.kpu.go.id/surabayakota/gayungan/gayungan
TPS 4,445,287,27,256,283,4,287,https://pilkada2015.kpu.go.id/surabayakota/gayungan/gayungan
TPS 5,649,384,50,332,382,2,384,https://pilkada2015.kpu.go.id/surabayakota/gayungan/gayungan
TPS 6,621,376,44,325,369,7,376,https://pilkada2015.kpu.go.id/surabayakota/gayungan/gayungan
TPS 7,363,162,19,143,162,0,162,https://pilkada2015.kpu.go.id/surabayakota/gayungan/gayungan
TPS 8,500,296,38,251,289,7,296,https://pilkada2015.kpu.go.id/surabayakota/gayungan/gayungan
TPS 9,333,217,29,184,213,4,217,https://pilkada2015.kpu.go.id/surabayakota/gayungan/gayungan
TPS 10,432,262,29,231,260,2,262,https://pilkada2015.kpu.go.id/surabayakota/gayungan/gayungan
TPS 11,459,249,27,222,249,0,249,https://pilkada2015.kpu.go.id/surabayakota/gayungan/gayungan
TPS 12,505,235,10,224,234,1,235,https://pilkada2015.kpu.go.id/surabayakota/gayungan/gayungan
TPS 13,394,223,17,203,220,3,223,https://pilkada2015.kpu.go.id/surabayakota/gayungan/gayungan
TPS 14,539,262,36,218,254,8,262,https://pilkada2015.kpu.go.id/surabayakota/gayungan/gayungan
TPS 1,398,244,17,225,242,2,244,https://pilkada2015.kpu.go.id/surabayakota/gayungan/ketintang
TPS 2,370,188,20,163,183,5,188,https://pilkada2015.kpu.go.id/surabayakota/gayungan/ketintang
TPS 3,542,268,32,228,260,8,268,https://pilkada2015.kpu.go.id/surabayakota/gayungan/ketintang
TPS 4,541,237,53,179,232,5,237,https://pilkada2015.kpu.go.id/surabayakota/gayungan/ketintang
TPS 5,534,312,49,259,308,4,312,https://pilkada2015.kpu.go.id/surabayakota/gayungan/ketintang
TPS 6,458,279,31,244,275,4,279,https://pilkada2015.kpu.go.id/surabayakota/gayungan/ketintang
TPS 7,428,225,19,203,222,3,225,https://pilkada2015.kpu.go.id/surabayakota/gayungan/ketintang
TPS 8,697,387,248,332,380,7,387,https://pilkada2015.kpu.go.id/surabayakota/gayungan/ketintang
TPS 9,618,299,31,264,295,4,299,https://pilkada2015.kpu.go.id/surabayakota/gayungan/ketintang
TPS 10,477,273,32,237,269,4,273,https://pilkada2015.kpu.go.id/surabayakota/gayungan/ketintang
TPS 11,573,295,30,260,290,5,295,https://pilkada2015.kpu.go.id/surabayakota/gayungan/ketintang
TPS 12,443,226,33,192,225,1,226,https://pilkada2015.kpu.go.id/surabayakota/gayungan/ketintang
TPS 13,643,377,59,308,367,10,377,https://pilkada2015.kpu.go.id/surabayakota/gayungan/ketintang
TPS 14,686,429,70,353,423,6,429,https://pilkada2015.kpu.go.id/surabayakota/gayungan/ketintang
TPS 15,392,235,31,202,233,2,235,https://pilkada2015.kpu.go.id/surabayakota/gayungan/ketintang
TPS 16,346,219,14,200,214,5,219,https://pilkada2015.kpu.go.id/surabayakota/gayungan/ketintang
TPS 17,288,172,26,146,172,0,172,https://pilkada2015.kpu.go.id/surabayakota/gayungan/ketintang
TPS 18,348,198,21,176,197,1,198,https://pilkada2015.kpu.go.id/surabayakota/gayungan/ketintang
TPS 19,415,240,35,204,239,0,240,https://pilkada2015.kpu.go.id/surabayakota/gayungan/ketintang
TPS 20,535,307,43,260,303,4,307,https://pilkada2015.kpu.go.id/surabayakota/gayungan/ketintang
TPS 1,459,224,32,191,223,1,224,https://pilkada2015.kpu.go.id/surabayakota/gayungan/menanggal
TPS 2,473,280,28,247,275,5,280,https://pilkada2015.kpu.go.id/surabayakota/gayungan/menanggal
TPS 3,493,282,26,252,278,4,282,https://pilkada2015.kpu.go.id/surabayakota/gayungan/menanggal
TPS 4,524,319,40,274,314,5,319,https://pilkada2015.kpu.go.id/surabayakota/gayungan/menanggal
TPS 5,532,277,16,257,273,4,277,https://pilkada2015.kpu.go.id/surabayakota/gayungan/menanggal
TPS 6,571,296,34,261,295,1,296,https://pilkada2015.kpu.go.id/surabayakota/gayungan/menanggal
TPS 7,432,236,30,204,234,2,236,https://pilkada2015.kpu.go.id/surabayakota/gayungan/menanggal
TPS 8,520,213,24,188,212,1,213,https://pilkada2015.kpu.go.id/surabayakota/gayungan/menanggal
TPS 9,378,243,26,212,238,5,243,https://pilkada2015.kpu.go.id/surabayakota/gayungan/menanggal
TPS 10,423,221,23,196,219,2,221,https://pilkada2015.kpu.go.id/surabayakota/gayungan/menanggal
TPS 11,433,243,32,207,239,4,243,https://pilkada2015.kpu.go.id/surabayakota/gayungan/menanggal
TPS 12,427,284,35,218,253,3,256,https://pilkada2015.kpu.go.id/surabayakota/gayungan/menanggal
TPS 13,482,274,62,209,271,3,274,https://pilkada2015.kpu.go.id/surabayakota/gayungan/menanggal
TPS 1,638,208,22,183,205,3,208,https://pilkada2015.kpu.go.id/surabayakota/genteng/embong_kaliasin
TPS 2,623,206,22,183,205,1,206,https://pilkada2015.kpu.go.id/surabayakota/genteng/embong_kaliasin
TPS 3,382,204,35,166,201,3,204,https://pilkada2015.kpu.go.id/surabayakota/genteng/embong_kaliasin
TPS 4,386,226,9,213,222,4,226,https://pilkada2015.kpu.go.id/surabayakota/genteng/embong_kaliasin
TPS 5,566,278,29,243,272,6,278,https://pilkada2015.kpu.go.id/surabayakota/genteng/embong_kaliasin
TPS 6,655,343,34,303,337,6,343,https://pilkada2015.kpu.go.id/surabayakota/genteng/embong_kaliasin
TPS 7,347,201,35,164,199,2,201,https://pilkada2015.kpu.go.id/surabayakota/genteng/embong_kaliasin
TPS 8,386,214,42,169,211,3,214,https://pilkada2015.kpu.go.id/surabayakota/genteng/embong_kaliasin
TPS 9,392,204,27,173,200,4,204,https://pilkada2015.kpu.go.id/surabayakota/genteng/embong_kaliasin
TPS 10,697,341,68,267,335,6,341,https://pilkada2015.kpu.go.id/surabayakota/genteng/embong_kaliasin
TPS 11,629,322,66,244,310,12,322,https://pilkada2015.kpu.go.id/surabayakota/genteng/embong_kaliasin
TPS 12,765,371,55,305,360,11,371,https://pilkada2015.kpu.go.id/surabayakota/genteng/embong_kaliasin
TPS 13,489,253,31,216,247,6,253,https://pilkada2015.kpu.go.id/surabayakota/genteng/embong_kaliasin
TPS 14,396,226,25,199,224,2,226,https://pilkada2015.kpu.go.id/surabayakota/genteng/embong_kaliasin
TPS 15,496,173,38,131,169,4,173,https://pilkada2015.kpu.go.id/surabayakota/genteng/embong_kaliasin
TPS 16,426,211,34,172,206,5,211,https://pilkada2015.kpu.go.id/surabayakota/genteng/embong_kaliasin
TPS 17,437,224,28,190,218,6,224,https://pilkada2015.kpu.go.id/surabayakota/genteng/embong_kaliasin
TPS 1,554,286,29,254,283,3,286,https://pilkada2015.kpu.go.id/surabayakota/genteng/genteng
TPS 2,524,271,45,222,267,4,271,https://pilkada2015.kpu.go.id/surabayakota/genteng/genteng
TPS 3,566,300,34,257,291,9,300,https://pilkada2015.kpu.go.id/surabayakota/genteng/genteng
TPS 4,465,201,14,182,196,5,201,https://pilkada2015.kpu.go.id/surabayakota/genteng/genteng
TPS 5,318,221,25,195,220,1,221,https://pilkada2015.kpu.go.id/surabayakota/genteng/genteng
TPS 6,536,280,36,234,270,10,280,https://pilkada2015.kpu.go.id/surabayakota/genteng/genteng
TPS 7,523,256,36,216,252,4,256,https://pilkada2015.kpu.go.id/surabayakota/genteng/genteng
TPS 8,409,164,18,146,164,3,167,https://pilkada2015.kpu.go.id/surabayakota/genteng/genteng
TPS 9,644,308,40,262,302,6,308,https://pilkada2015.kpu.go.id/surabayakota/genteng/genteng
TPS 10,622,265,29,236,265,0,265,https://pilkada2015.kpu.go.id/surabayakota/genteng/genteng
TPS 11,552,264,26,233,259,5,264,https://pilkada2015.kpu.go.id/surabayakota/genteng/genteng
TPS 12,418,222,30,185,215,7,222,https://pilkada2015.kpu.go.id/surabayakota/genteng/genteng
TPS 13,395,184,18,163,181,3,184,https://pilkada2015.kpu.go.id/surabayakota/genteng/genteng
TPS 1,485,182,24,155,179,3,182,https://pilkada2015.kpu.go.id/surabayakota/genteng/kapasari
TPS 2,551,277,30,247,277,0,277,https://pilkada2015.kpu.go.id/surabayakota/genteng/kapasari
TPS 3,523,247,44,199,243,4,247,https://pilkada2015.kpu.go.id/surabayakota/genteng/kapasari
TPS 4,500,220,43,173,216,4,220,https://pilkada2015.kpu.go.id/surabayakota/genteng/kapasari
TPS 5,450,232,39,188,227,5,232,https://pilkada2015.kpu.go.id/surabayakota/genteng/kapasari
TPS 6,477,202,22,177,199,3,202,https://pilkada2015.kpu.go.id/surabayakota/genteng/kapasari
TPS 7,479,224,32,189,221,3,224,https://pilkada2015.kpu.go.id/surabayakota/genteng/kapasari
TPS 8,458,195,45,146,191,4,195,https://pilkada2015.kpu.go.id/surabayakota/genteng/kapasari
TPS 9,441,203,38,163,201,2,203,https://pilkada2015.kpu.go.id/surabayakota/genteng/kapasari
TPS 10,581,226,17,206,223,3,226,https://pilkada2015.kpu.go.id/surabayakota/genteng/kapasari
TPS 11,534,269,28,235,263,6,269,https://pilkada2015.kpu.go.id/surabayakota/genteng/kapasari
TPS 12,582,220,21,195,216,4,220,https://pilkada2015.kpu.go.id/surabayakota/genteng/kapasari
TPS 13,566,231,25,197,222,9,231,https://pilkada2015.kpu.go.id/surabayakota/genteng/kapasari
TPS 14,489,215,27,184,211,4,215,https://pilkada2015.kpu.go.id/surabayakota/genteng/kapasari
TPS 15,519,328,35,286,321,7,328,https://pilkada2015.kpu.go.id/surabayakota/genteng/kapasari
TPS 16,434,198,30,166,196,2,198,https://pilkada2015.kpu.go.id/surabayakota/genteng/kapasari
TPS 17,495,252,35,213,248,4,252,https://pilkada2015.kpu.go.id/surabayakota/genteng/kapasari
TPS 18,448,259,23,234,257,2,259,https://pilkada2015.kpu.go.id/surabayakota/genteng/kapasari
TPS 19,461,214,21,191,212,2,214,https://pilkada2015.kpu.go.id/surabayakota/genteng/kapasari
TPS 20,0,254,36,213,249,5,254,https://pilkada2015.kpu.go.id/surabayakota/genteng/kapasari
TPS 21,542,263,35,225,260,3,263,https://pilkada2015.kpu.go.id/surabayakota/genteng/kapasari
TPS 22,483,266,60,200,260,6,266,https://pilkada2015.kpu.go.id/surabayakota/genteng/kapasari
TPS 23,368,161,9,150,159,2,161,https://pilkada2015.kpu.go.id/surabayakota/genteng/kapasari
TPS 24,411,177,15,160,175,2,177,https://pilkada2015.kpu.go.id/surabayakota/genteng/kapasari
TPS 1,699,294,36,253,289,5,294,https://pilkada2015.kpu.go.id/surabayakota/genteng/ketabang
TPS 2,682,268,26,239,3,265,268,https://pilkada2015.kpu.go.id/surabayakota/genteng/ketabang
TPS 3,680,319,25,294,319,0,319,https://pilkada2015.kpu.go.id/surabayakota/genteng/ketabang
TPS 4,266,108,7,97,104,4,108,https://pilkada2015.kpu.go.id/surabayakota/genteng/ketabang
TPS 5,386,83,10,73,83,0,83,https://pilkada2015.kpu.go.id/surabayakota/genteng/ketabang
TPS 6,296,97,9,87,96,1,97,https://pilkada2015.kpu.go.id/surabayakota/genteng/ketabang
TPS 7,572,282,63,210,273,9,282,https://pilkada2015.kpu.go.id/surabayakota/genteng/ketabang
TPS 8,405,162,10,151,161,1,162,https://pilkada2015.kpu.go.id/surabayakota/genteng/ketabang
TPS 9,793,294,24,270,294,0,294,https://pilkada2015.kpu.go.id/surabayakota/genteng/ketabang
TPS 10,786,326,49,275,324,2,326,https://pilkada2015.kpu.go.id/surabayakota/genteng/ketabang
TPS 11,777,449,39,401,440,9,449,https://pilkada2015.kpu.go.id/surabayakota/genteng/ketabang
TPS 1,543,243,51,187,238,5,243,https://pilkada2015.kpu.go.id/surabayakota/genteng/peneleh
TPS 2,502,261,58,200,258,3,261,https://pilkada2015.kpu.go.id/surabayakota/genteng/peneleh
TPS 3,777,360,56,299,5,355,360,https://pilkada2015.kpu.go.id/surabayakota/genteng/peneleh
TPS 4,765,303,25,273,298,5,303,https://pilkada2015.kpu.go.id/surabayakota/genteng/peneleh
TPS 5,528,201,30,168,198,3,201,https://pilkada2015.kpu.go.id/surabayakota/genteng/peneleh
TPS 6,526,234,37,194,231,3,234,https://pilkada2015.kpu.go.id/surabayakota/genteng/peneleh
TPS 7,650,250,26,218,244,6,250,https://pilkada2015.kpu.go.id/surabayakota/genteng/peneleh
TPS 8,610,293,39,251,290,3,293,https://pilkada2015.kpu.go.id/surabayakota/genteng/peneleh
TPS 9,710,290,47,240,287,3,290,https://pilkada2015.kpu.go.id/surabayakota/genteng/peneleh
TPS 10,631,238,79,158,237,1,238,https://pilkada2015.kpu.go.id/surabayakota/genteng/peneleh
TPS 11,305,159,17,141,158,1,159,https://pilkada2015.kpu.go.id/surabayakota/genteng/peneleh
TPS 12,316,150,17,132,149,1,150,https://pilkada2015.kpu.go.id/surabayakota/genteng/peneleh
TPS 13,585,247,39,206,0,0,0,https://pilkada2015.kpu.go.id/surabayakota/genteng/peneleh
TPS 14,378,154,10,142,152,2,154,https://pilkada2015.kpu.go.id/surabayakota/genteng/peneleh
TPS 15,538,239,38,194,232,7,239,https://pilkada2015.kpu.go.id/surabayakota/genteng/peneleh
TPS 16,499,254,28,221,249,5,254,https://pilkada2015.kpu.go.id/surabayakota/genteng/peneleh
TPS 17,498,187,31,149,180,7,187,https://pilkada2015.kpu.go.id/surabayakota/genteng/peneleh
TPS 18,625,283,32,244,276,7,283,https://pilkada2015.kpu.go.id/surabayakota/genteng/peneleh
TPS 19,712,286,17,264,281,5,286,https://pilkada2015.kpu.go.id/surabayakota/genteng/peneleh
TPS 20,486,196,22,172,194,2,196,https://pilkada2015.kpu.go.id/surabayakota/genteng/peneleh
TPS 21,586,383,19,360,379,4,383,https://pilkada2015.kpu.go.id/surabayakota/genteng/peneleh
TPS 22,581,351,13,331,344,7,351,https://pilkada2015.kpu.go.id/surabayakota/genteng/peneleh
TPS 1,587,330,43,279,322,8,330,https://pilkada2015.kpu.go.id/surabayakota/gubeng/airlangga
TPS 2,588,317,54,258,312,5,317,https://pilkada2015.kpu.go.id/surabayakota/gubeng/airlangga
TPS 3,261,261,55,193,248,8,256,https://pilkada2015.kpu.go.id/surabayakota/gubeng/airlangga
TPS 4,404,196,47,147,194,2,196,https://pilkada2015.kpu.go.id/surabayakota/gubeng/airlangga
TPS 5,506,253,46,202,248,5,253,https://pilkada2015.kpu.go.id/surabayakota/gubeng/airlangga
TPS 6,633,353,48,299,347,6,353,https://pilkada2015.kpu.go.id/surabayakota/gubeng/airlangga
TPS 7,529,300,35,258,293,7,300,https://pilkada2015.kpu.go.id/surabayakota/gubeng/airlangga
TPS 8,466,272,40,227,267,5,272,https://pilkada2015.kpu.go.id/surabayakota/gubeng/airlangga
TPS 9,0,0,24,196,220,2,222,https://pilkada2015.kpu.go.id/surabayakota/gubeng/airlangga
TPS 10,571,313,23,289,312,1,313,https://pilkada2015.kpu.go.id/surabayakota/gubeng/airlangga
TPS 11,519,247,20,220,240,7,247,https://pilkada2015.kpu.go.id/surabayakota/gubeng/airlangga
TPS 12,618,353,26,325,351,2,353,https://pilkada2015.kpu.go.id/surabayakota/gubeng/airlangga
TPS 13,252,158,17,138,155,3,158,https://pilkada2015.kpu.go.id/surabayakota/gubeng/airlangga
TPS 14,377,200,26,174,200,0,200,https://pilkada2015.kpu.go.id/surabayakota/gubeng/airlangga
TPS 15,669,362,34,321,355,7,362,https://pilkada2015.kpu.go.id/surabayakota/gubeng/airlangga
TPS 16,576,268,30,234,264,4,268,https://pilkada2015.kpu.go.id/surabayakota/gubeng/airlangga
TPS 17,666,324,36,279,315,9,324,https://pilkada2015.kpu.go.id/surabayakota/gubeng/airlangga
TPS 18,486,249,28,218,246,3,249,https://pilkada2015.kpu.go.id/surabayakota/gubeng/airlangga
TPS 19,446,242,26,211,237,5,242,https://pilkada2015.kpu.go.id/surabayakota/gubeng/airlangga
TPS 20,654,347,43,300,343,4,347,https://pilkada2015.kpu.go.id/surabayakota/gubeng/airlangga
TPS 21,433,279,31,246,277,2,279,https://pilkada2015.kpu.go.id/surabayakota/gubeng/airlangga
TPS 22,339,172,30,131,161,11,172,https://pilkada2015.kpu.go.id/surabayakota/gubeng/airlangga
TPS 23,475,263,38,224,262,1,263,https://pilkada2015.kpu.go.id/surabayakota/gubeng/airlangga
TPS 24,392,165,33,127,160,5,165,https://pilkada2015.kpu.go.id/surabayakota/gubeng/airlangga
TPS 25,590,344,79,263,342,2,344,https://pilkada2015.kpu.go.id/surabayakota/gubeng/airlangga
TPS 26,635,365,51,308,359,6,365,https://pilkada2015.kpu.go.id/surabayakota/gubeng/airlangga
TPS 27,449,256,29,219,248,8,256,https://pilkada2015.kpu.go.id/surabayakota/gubeng/airlangga
TPS 28,435,283,55,225,280,3,283,https://pilkada2015.kpu.go.id/surabayakota/gubeng/airlangga
TPS 29,698,336,55,276,331,5,336,https://pilkada2015.kpu.go.id/surabayakota/gubeng/airlangga
TPS 1,496,255,23,227,250,5,255,https://pilkada2015.kpu.go.id/surabayakota/gubeng/baratajaya
TPS 2,438,220,16,199,215,5,220,https://pilkada2015.kpu.go.id/surabayakota/gubeng/baratajaya
TPS 3,501,223,19,201,220,3,223,https://pilkada2015.kpu.go.id/surabayakota/gubeng/baratajaya
TPS 4,498,217,33,183,216,1,217,https://pilkada2015.kpu.go.id/surabayakota/gubeng/baratajaya
TPS 5,409,262,22,237,259,3,262,https://pilkada2015.kpu.go.id/surabayakota/gubeng/baratajaya
TPS 6,384,254,35,217,252,2,254,https://pilkada2015.kpu.go.id/surabayakota/gubeng/baratajaya
TPS 7,390,223,32,188,220,3,223,https://pilkada2015.kpu.go.id/surabayakota/gubeng/baratajaya
TPS 8,604,277,21,243,264,5,269,https://pilkada2015.kpu.go.id/surabayakota/gubeng/baratajaya
TPS 9,651,309,25,278,303,6,309,https://pilkada2015.kpu.go.id/surabayakota/gubeng/baratajaya
TPS 10,640,277,26,244,270,7,272,https://pilkada2015.kpu.go.id/surabayakota/gubeng/baratajaya
TPS 11,634,282,29,250,279,3,282,https://pilkada2015.kpu.go.id/surabayakota/gubeng/baratajaya
TPS 12,617,302,56,240,296,6,302,https://pilkada2015.kpu.go.id/surabayakota/gubeng/baratajaya
TPS 13,610,263,42,217,259,4,263,https://pilkada2015.kpu.go.id/surabayakota/gubeng/baratajaya
TPS 14,475,215,20,193,213,2,215,https://pilkada2015.kpu.go.id/surabayakota/gubeng/baratajaya
TPS 15,511,272,23,245,268,4,272,https://pilkada2015.kpu.go.id/surabayakota/gubeng/baratajaya
TPS 16,515,299,33,261,294,5,299,https://pilkada2015.kpu.go.id/surabayakota/gubeng/baratajaya
TPS 17,627,325,55,263,318,7,325,https://pilkada2015.kpu.go.id/surabayakota/gubeng/baratajaya
TPS 18,576,283,38,240,278,5,283,https://pilkada2015.kpu.go.id/surabayakota/gubeng/baratajaya
TPS 19,497,225,30,193,223,2,225,https://pilkada2015.kpu.go.id/surabayakota/gubeng/baratajaya
TPS 20,498,246,24,222,246,0,246,https://pilkada2015.kpu.go.id/surabayakota/gubeng/baratajaya
TPS 21,521,286,35,249,284,2,286,https://pilkada2015.kpu.go.id/surabayakota/gubeng/baratajaya
TPS 22,564,320,48,263,311,9,320,https://pilkada2015.kpu.go.id/surabayakota/gubeng/baratajaya
TPS 23,493,275,46,224,270,5,275,https://pilkada2015.kpu.go.id/surabayakota/gubeng/baratajaya
TPS 1,495,263,30,226,256,7,263,https://pilkada2015.kpu.go.id/surabayakota/gubeng/gubeng
TPS 2,668,361,35,324,359,2,361,https://pilkada2015.kpu.go.id/surabayakota/gubeng/gubeng
TPS 3,504,307,44,259,303,4,307,https://pilkada2015.kpu.go.id/surabayakota/gubeng/gubeng
TPS 4,544,246,16,226,242,4,246,https://pilkada2015.kpu.go.id/surabayakota/gubeng/gubeng
TPS 5,488,488,18,280,298,4,302,https://pilkada2015.kpu.go.id/surabayakota/gubeng/gubeng
TPS 6,596,334,41,288,329,5,334,https://pilkada2015.kpu.go.id/surabayakota/gubeng/gubeng
TPS 7,565,341,65,274,339,2,341,https://pilkada2015.kpu.go.id/surabayakota/gubeng/gubeng
TPS 8,572,288,42,239,281,7,288,https://pilkada2015.kpu.go.id/surabayakota/gubeng/gubeng
TPS 9,476,264,32,228,260,4,264,https://pilkada2015.kpu.go.id/surabayakota/gubeng/gubeng
TPS 10,421,249,41,205,246,3,249,https://pilkada2015.kpu.go.id/surabayakota/gubeng/gubeng
TPS 11,424,221,30,190,220,1,221,https://pilkada2015.kpu.go.id/surabayakota/gubeng/gubeng
TPS 12,567,283,35,243,278,5,283,https://pilkada2015.kpu.go.id/surabayakota/gubeng/gubeng
TPS 13,456,246,31,207,238,8,246,https://pilkada2015.kpu.go.id/surabayakota/gubeng/gubeng
TPS 14,572,572,62,229,291,6,297,https://pilkada2015.kpu.go.id/surabayakota/gubeng/gubeng
TPS 15,501,291,46,241,287,4,291,https://pilkada2015.kpu.go.id/surabayakota/gubeng/gubeng
TPS 16,639,344,38,298,336,8,344,https://pilkada2015.kpu.go.id/surabayakota/gubeng/gubeng
TPS 17,562,329,64,260,324,5,329,https://pilkada2015.kpu.go.id/surabayakota/gubeng/gubeng
TPS 18,670,318,51,262,313,5,318,https://pilkada2015.kpu.go.id/surabayakota/gubeng/gubeng
TPS 19,479,175,12,163,175,0,175,https://pilkada2015.kpu.go.id/surabayakota/gubeng/gubeng
TPS 20,365,113,9,101,110,3,113,https://pilkada2015.kpu.go.id/surabayakota/gubeng/gubeng
TPS 21,388,158,19,139,158,0,158,https://pilkada2015.kpu.go.id/surabayakota/gubeng/gubeng
TPS 1,345,180,17,161,178,2,180,https://pilkada2015.kpu.go.id/surabayakota/gubeng/kertajaya
TPS 2,438,178,30,146,176,2,178,https://pilkada2015.kpu.go.id/surabayakota/gubeng/kertajaya
TPS 3,267,128,19,106,125,3,128,https://pilkada2015.kpu.go.id/surabayakota/gubeng/kertajaya
TPS 4,324,148,22,124,146,2,148,https://pilkada2015.kpu.go.id/surabayakota/gubeng/kertajaya
TPS 5,419,218,46,169,215,3,218,https://pilkada2015.kpu.go.id/surabayakota/gubeng/kertajaya
TPS 6,740,391,42,343,385,6,391,https://pilkada2015.kpu.go.id/surabayakota/gubeng/kertajaya
TPS 7,567,313,33,278,311,2,313,https://pilkada2015.kpu.go.id/surabayakota/gubeng/kertajaya
TPS 8,764,326,40,281,321,5,326,https://pilkada2015.kpu.go.id/surabayakota/gubeng/kertajaya
TPS 9,742,293,32,260,292,1,293,https://pilkada2015.kpu.go.id/surabayakota/gubeng/kertajaya
TPS 10,678,346,39,300,339,7,346,https://pilkada2015.kpu.go.id/surabayakota/gubeng/kertajaya
TPS 11,579,290,33,215,248,1,249,https://pilkada2015.kpu.go.id/surabayakota/gubeng/kertajaya
TPS 12,495,235,27,202,229,6,235,https://pilkada2015.kpu.go.id/surabayakota/gubeng/kertajaya
TPS 13,567,272,36,228,264,8,272,https://pilkada2015.kpu.go.id/surabayakota/gubeng/kertajaya
TPS 14,563,302,27,272,299,3,302,https://pilkada2015.kpu.go.id/surabayakota/gubeng/kertajaya
TPS 15,755,336,82,252,334,2,336,https://pilkada2015.kpu.go.id/surabayakota/gubeng/kertajaya
TPS 16,369,164,17,147,164,0,164,https://pilkada2015.kpu.go.id/surabayakota/gubeng/kertajaya
TPS 17,236,141,13,127,140,1,141,https://pilkada2015.kpu.go.id/surabayakota/gubeng/kertajaya
TPS 18,497,199,26,171,197,2,199,https://pilkada2015.kpu.go.id/surabayakota/gubeng/kertajaya
TPS 19,593,302,32,269,301,1,302,https://pilkada2015.kpu.go.id/surabayakota/gubeng/kertajaya
TPS 20,640,339,51,283,334,5,339,https://pilkada2015.kpu.go.id/surabayakota/gubeng/kertajaya
TPS 21,716,309,46,260,306,3,309,https://pilkada2015.kpu.go.id/surabayakota/gubeng/kertajaya
TPS 22,473,242,30,206,236,6,242,https://pilkada2015.kpu.go.id/surabayakota/gubeng/kertajaya
TPS 23,462,275,36,235,271,4,275,https://pilkada2015.kpu.go.id/surabayakota/gubeng/kertajaya
TPS 24,330,203,26,176,202,1,203,https://pilkada2015.kpu.go.id/surabayakota/gubeng/kertajaya
TPS 25,749,336,19,307,326,10,336,https://pilkada2015.kpu.go.id/surabayakota/gubeng/kertajaya
TPS 26,263,151,18,130,148,3,151,https://pilkada2015.kpu.go.id/surabayakota/gubeng/kertajaya
TPS 27,242,128,14,113,127,1,128,https://pilkada2015.kpu.go.id/surabayakota/gubeng/kertajaya
TPS 28,483,288,40,242,282,6,288,https://pilkada2015.kpu.go.id/surabayakota/gubeng/kertajaya
TPS 29,720,297,53,241,297,0,297,https://pilkada2015.kpu.go.id/surabayakota/gubeng/kertajaya
TPS 30,555,295,71,221,292,3,295,https://pilkada2015.kpu.go.id/surabayakota/gubeng/kertajaya
TPS 31,588,327,54,267,321,6,327,https://pilkada2015.kpu.go.id/surabayakota/gubeng/kertajaya
TPS 32,727,416,76,337,413,3,416,https://pilkada2015.kpu.go.id/surabayakota/gubeng/kertajaya
TPS 33,487,277,36,236,272,5,277,https://pilkada2015.kpu.go.id/surabayakota/gubeng/kertajaya
TPS 34,379,180,23,157,180,0,180,https://pilkada2015.kpu.go.id/surabayakota/gubeng/kertajaya
TPS 35,499,213,37,175,212,1,213,https://pilkada2015.kpu.go.id/surabayakota/gubeng/kertajaya
TPS 36,716,364,59,301,360,4,364,https://pilkada2015.kpu.go.id/surabayakota/gubeng/kertajaya
TPS 1,342,168,5,163,168,0,168,https://pilkada2015.kpu.go.id/surabayakota/gubeng/mojo
TPS 2,382,240,17,222,239,1,240,https://pilkada2015.kpu.go.id/surabayakota/gubeng/mojo
TPS 3,522,238,24,209,233,0,238,https://pilkada2015.kpu.go.id/surabayakota/gubeng/mojo
TPS 4,590,300,42,253,295,5,300,https://pilkada2015.kpu.go.id/surabayakota/gubeng/mojo
TPS 5,717,345,45,295,340,5,345,https://pilkada2015.kpu.go.id/surabayakota/gubeng/mojo
TPS 6,481,205,4,200,204,1,205,https://pilkada2015.kpu.go.id/surabayakota/gubeng/mojo
TPS 7,0,0,36,171,0,0,0,https://pilkada2015.kpu.go.id/surabayakota/gubeng/mojo
TPS 8,450,274,40,229,269,5,274,https://pilkada2015.kpu.go.id/surabayakota/gubeng/mojo
TPS 9,457,244,29,204,233,11,244,https://pilkada2015.kpu.go.id/surabayakota/gubeng/mojo
TPS 10,0,299,38,259,297,2,299,https://pilkada2015.kpu.go.id/surabayakota/gubeng/mojo
TPS 11,550,293,40,248,288,5,293,https://pilkada2015.kpu.go.id/surabayakota/gubeng/mojo
TPS 12,630,235,24,211,235,0,235,https://pilkada2015.kpu.go.id/surabayakota/gubeng/mojo
TPS 13,487,279,43,234,277,2,279,https://pilkada2015.kpu.go.id/surabayakota/gubeng/mojo
TPS 14,573,348,40,307,347,1,348,https://pilkada2015.kpu.go.id/surabayakota/gubeng/mojo
TPS 15,514,317,40,273,313,4,317,https://pilkada2015.kpu.go.id/surabayakota/gubeng/mojo
TPS 16,550,340,62,278,340,0,340,https://pilkada2015.kpu.go.id/surabayakota/gubeng/mojo
TPS 17,515,295,60,232,292,3,295,https://pilkada2015.kpu.go.id/surabayakota/gubeng/mojo
TPS 18,488,316,23,291,314,2,316,https://pilkada2015.kpu.go.id/surabayakota/gubeng/mojo
TPS 19,495,266,45,219,264,2,266,https://pilkada2015.kpu.go.id/surabayakota/gubeng/mojo
TPS 20,630,318,37,277,314,4,318,https://pilkada2015.kpu.go.id/surabayakota/gubeng/mojo
TPS 21,529,265,32,230,262,3,265,https://pilkada2015.kpu.go.id/surabayakota/gubeng/mojo
TPS 22,447,247,31,215,246,1,244,https://pilkada2015.kpu.go.id/surabayakota/gubeng/mojo
TPS 23,449,233,24,207,231,2,233,https://pilkada2015.kpu.go.id/surabayakota/gubeng/mojo
TPS 24,330,181,13,167,180,1,181,https://pilkada2015.kpu.go.id/surabayakota/gubeng/mojo
TPS 25,559,353,36,313,349,4,353,https://pilkada2015.kpu.go.id/surabayakota/gubeng/mojo
TPS 26,580,250,43,206,249,1,250,https://pilkada2015.kpu.go.id/surabayakota/gubeng/mojo
TPS 27,631,343,39,301,340,3,343,https://pilkada2015.kpu.go.id/surabayakota/gubeng/mojo
TPS 28,547,297,52,239,291,6,297,https://pilkada2015.kpu.go.id/surabayakota/gubeng/mojo
TPS 29,474,247,30,213,243,4,247,https://pilkada2015.kpu.go.id/surabayakota/gubeng/mojo
TPS 30,514,343,32,304,336,7,343,https://pilkada2015.kpu.go.id/surabayakota/gubeng/mojo
TPS 31,553,325,40,277,317,8,325,https://pilkada2015.kpu.go.id/surabayakota/gubeng/mojo
TPS 32,652,332,50,278,328,4,332,https://pilkada2015.kpu.go.id/surabayakota/gubeng/mojo
TPS 33,646,367,442,316,258,9,367,https://pilkada2015.kpu.go.id/surabayakota/gubeng/mojo
TPS 34,398,245,31,210,241,4,245,https://pilkada2015.kpu.go.id/surabayakota/gubeng/mojo
TPS 35,462,249,21,222,243,6,249,https://pilkada2015.kpu.go.id/surabayakota/gubeng/mojo
TPS 36,602,328,35,291,326,2,328,https://pilkada2015.kpu.go.id/surabayakota/gubeng/mojo
TPS 37,665,363,49,307,356,7,363,https://pilkada2015.kpu.go.id/surabayakota/gubeng/mojo
TPS 38,449,268,39,228,267,1,268,https://pilkada2015.kpu.go.id/surabayakota/gubeng/mojo
TPS 39,542,278,33,242,275,3,278,https://pilkada2015.kpu.go.id/surabayakota/gubeng/mojo
TPS 40,489,294,39,251,290,4,294,https://pilkada2015.kpu.go.id/surabayakota/gubeng/mojo
TPS 41,0,0,0,0,0,0,0,https://pilkada2015.kpu.go.id/surabayakota/gubeng/mojo
TPS 42,614,309,26,279,305,4,309,https://pilkada2015.kpu.go.id/surabayakota/gubeng/mojo
TPS 43,702,401,43,355,0,0,0,https://pilkada2015.kpu.go.id/surabayakota/gubeng/mojo
TPS 44,567,292,52,231,283,9,292,https://pilkada2015.kpu.go.id/surabayakota/gubeng/mojo
TPS 45,543,333,55,276,331,2,333,https://pilkada2015.kpu.go.id/surabayakota/gubeng/mojo
TPS 46,577,330,83,240,322,7,330,https://pilkada2015.kpu.go.id/surabayakota/gubeng/mojo
TPS 47,408,238,26,209,235,3,238,https://pilkada2015.kpu.go.id/surabayakota/gubeng/mojo
TPS 48,475,305,19,281,300,5,305,https://pilkada2015.kpu.go.id/surabayakota/gubeng/mojo
TPS 49,535,215,25,189,214,1,215,https://pilkada2015.kpu.go.id/surabayakota/gubeng/mojo
TPS 50,580,225,18,206,224,1,225,https://pilkada2015.kpu.go.id/surabayakota/gubeng/mojo
TPS 51,606,334,30,297,327,7,334,https://pilkada2015.kpu.go.id/surabayakota/gubeng/mojo
TPS 52,576,342,18,317,335,7,342,https://pilkada2015.kpu.go.id/surabayakota/gubeng/mojo
TPS 53,568,349,50,293,343,6,349,https://pilkada2015.kpu.go.id/surabayakota/gubeng/mojo
TPS 54,464,308,41,262,303,5,308,https://pilkada2015.kpu.go.id/surabayakota/gubeng/mojo
TPS 55,558,299,26,268,294,5,299,https://pilkada2015.kpu.go.id/surabayakota/gubeng/mojo
TPS 56,607,368,46,310,356,12,368,https://pilkada2015.kpu.go.id/surabayakota/gubeng/mojo
TPS 57,560,255,41,212,253,2,255,https://pilkada2015.kpu.go.id/surabayakota/gubeng/mojo
TPS 58,591,334,27,303,330,4,334,https://pilkada2015.kpu.go.id/surabayakota/gubeng/mojo
TPS 59,752,416,65,347,412,4,416,https://pilkada2015.kpu.go.id/surabayakota/gubeng/mojo
TPS 60,707,394,61,323,384,10,394,https://pilkada2015.kpu.go.id/surabayakota/gubeng/mojo
TPS 61,365,231,28,199,227,4,231,https://pilkada2015.kpu.go.id/surabayakota/gubeng/mojo
TPS 1,514,223,24,199,223,0,0,https://pilkada2015.kpu.go.id/surabayakota/gubeng/pucang_sewu
TPS 2,444,209,19,189,208,1,209,https://pilkada2015.kpu.go.id/surabayakota/gubeng/pucang_sewu
TPS 3,573,263,14,246,260,3,263,https://pilkada2015.kpu.go.id/surabayakota/gubeng/pucang_sewu
TPS 4,617,250,14,235,249,1,250,https://pilkada2015.kpu.go.id/surabayakota/gubeng/pucang_sewu
TPS 5,537,295,20,272,292,3,295,https://pilkada2015.kpu.go.id/surabayakota/gubeng/pucang_sewu
TPS 6,455,233,21,211,232,1,233,https://pilkada2015.kpu.go.id/surabayakota/gubeng/pucang_sewu
TPS 7,563,256,37,213,250,6,256,https://pilkada2015.kpu.go.id/surabayakota/gubeng/pucang_sewu
TPS 8,551,173,28,143,171,0,173,https://pilkada2015.kpu.go.id/surabayakota/gubeng/pucang_sewu
TPS 9,470,255,16,236,252,3,255,https://pilkada2015.kpu.go.id/surabayakota/gubeng/pucang_sewu
TPS 10,474,269,21,239,260,9,269,https://pilkada2015.kpu.go.id/surabayakota/gubeng/pucang_sewu
TPS 11,425,245,18,223,241,4,245,https://pilkada2015.kpu.go.id/surabayakota/gubeng/pucang_sewu
TPS 12,528,305,38,259,297,8,305,https://pilkada2015.kpu.go.id/surabayakota/gubeng/pucang_sewu
TPS 13,594,297,33,257,290,7,297,https://pilkada2015.kpu.go.id/surabayakota/gubeng/pucang_sewu
TPS 14,690,305,28,274,302,3,305,https://pilkada2015.kpu.go.id/surabayakota/gubeng/pucang_sewu
TPS 15,592,288,36,244,280,8,288,https://pilkada2015.kpu.go.id/surabayakota/gubeng/pucang_sewu
TPS 16,668,286,25,255,280,6,286,https://pilkada2015.kpu.go.id/surabayakota/gubeng/pucang_sewu
TPS 17,0,223,38,184,222,1,223,https://pilkada2015.kpu.go.id/surabayakota/gubeng/pucang_sewu
TPS 18,433,237,23,214,237,0,237,https://pilkada2015.kpu.go.id/surabayakota/gubeng/pucang_sewu
TPS 19,437,226,22,202,224,2,226,https://pilkada2015.kpu.go.id/surabayakota/gubeng/pucang_sewu
TPS 20,550,258,40,212,252,6,258,https://pilkada2015.kpu.go.id/surabayakota/gubeng/pucang_sewu
TPS 21,377,139,18,121,139,0,139,https://pilkada2015.kpu.go.id/surabayakota/gubeng/pucang_sewu
TPS 1,596,302,34,263,297,5,302,https://pilkada2015.kpu.go.id/surabayakota/gunung_anyar/gunung_anyar
TPS 2,319,173,15,155,170,3,173,https://pilkada2015.kpu.go.id/surabayakota/gunung_anyar/gunung_anyar
TPS 3,533,361,25,332,357,4,361,https://pilkada2015.kpu.go.id/surabayakota/gunung_anyar/gunung_anyar
TPS 4,660,374,44,324,368,6,374,https://pilkada2015.kpu.go.id/surabayakota/gunung_anyar/gunung_anyar
TPS 5,609,404,42,357,399,5,404,https://pilkada2015.kpu.go.id/surabayakota/gunung_anyar/gunung_anyar
TPS 6,673,394,39,350,389,5,394,https://pilkada2015.kpu.go.id/surabayakota/gunung_anyar/gunung_anyar
TPS 7,694,428,35,381,416,12,428,https://pilkada2015.kpu.go.id/surabayakota/gunung_anyar/gunung_anyar
TPS 8,420,269,39,224,263,6,269,https://pilkada2015.kpu.go.id/surabayakota/gunung_anyar/gunung_anyar
TPS 9,696,357,51,302,353,4,357,https://pilkada2015.kpu.go.id/surabayakota/gunung_anyar/gunung_anyar
TPS 10,417,202,15,186,201,1,202,https://pilkada2015.kpu.go.id/surabayakota/gunung_anyar/gunung_anyar
TPS 11,438,216,19,194,213,3,216,https://pilkada2015.kpu.go.id/surabayakota/gunung_anyar/gunung_anyar
TPS 12,394,219,16,200,216,3,219,https://pilkada2015.kpu.go.id/surabayakota/gunung_anyar/gunung_anyar
TPS 13,502,275,34,238,272,3,275,https://pilkada2015.kpu.go.id/surabayakota/gunung_anyar/gunung_anyar
TPS 14,704,419,50,359,409,10,409,https://pilkada2015.kpu.go.id/surabayakota/gunung_anyar/gunung_anyar
TPS 15,593,338,27,307,334,4,338,https://pilkada2015.kpu.go.id/surabayakota/gunung_anyar/gunung_anyar
TPS 16,705,432,42,388,430,2,432,https://pilkada2015.kpu.go.id/surabayakota/gunung_anyar/gunung_anyar
TPS 17,619,361,51,306,357,4,361,https://pilkada2015.kpu.go.id/surabayakota/gunung_anyar/gunung_anyar
TPS 18,662,411,55,353,408,3,411,https://pilkada2015.kpu.go.id/surabayakota/gunung_anyar/gunung_anyar
TPS 19,672,420,0,0,417,3,420,https://pilkada2015.kpu.go.id/surabayakota/gunung_anyar/gunung_anyar
TPS 20,771,380,57,316,373,7,380,https://pilkada2015.kpu.go.id/surabayakota/gunung_anyar/gunung_anyar
TPS 21,283,168,18,146,164,4,168,https://pilkada2015.kpu.go.id/surabayakota/gunung_anyar/gunung_anyar
TPS 22,491,236,16,220,236,0,236,https://pilkada2015.kpu.go.id/surabayakota/gunung_anyar/gunung_anyar
TPS 23,489,252,21,229,250,2,252,https://pilkada2015.kpu.go.id/surabayakota/gunung_anyar/gunung_anyar
TPS 24,553,251,11,240,251,0,251,https://pilkada2015.kpu.go.id/surabayakota/gunung_anyar/gunung_anyar
TPS 1,604,317,48,263,311,6,317,https://pilkada2015.kpu.go.id/surabayakota/gunung_anyar/gunung_anyar_tambak
TPS 2,542,307,32,272,304,3,307,https://pilkada2015.kpu.go.id/surabayakota/gunung_anyar/gunung_anyar_tambak
TPS 3,611,328,20,306,326,2,328,https://pilkada2015.kpu.go.id/surabayakota/gunung_anyar/gunung_anyar_tambak
TPS 4,787,411,36,372,408,3,411,https://pilkada2015.kpu.go.id/surabayakota/gunung_anyar/gunung_anyar_tambak
TPS 5,642,342,44,294,338,4,342,https://pilkada2015.kpu.go.id/surabayakota/gunung_anyar/gunung_anyar_tambak
TPS 6,404,240,16,224,240,0,240,https://pilkada2015.kpu.go.id/surabayakota/gunung_anyar/gunung_anyar_tambak
TPS 7,360,238,17,221,238,0,238,https://pilkada2015.kpu.go.id/surabayakota/gunung_anyar/gunung_anyar_tambak
TPS 8,507,291,26,260,286,5,291,https://pilkada2015.kpu.go.id/surabayakota/gunung_anyar/gunung_anyar_tambak
TPS 9,683,446,40,401,441,5,446,https://pilkada2015.kpu.go.id/surabayakota/gunung_anyar/gunung_anyar_tambak
TPS 10,558,317,51,259,310,7,317,https://pilkada2015.kpu.go.id/surabayakota/gunung_anyar/gunung_anyar_tambak
TPS 1,582,345,0,0,0,0,0,https://pilkada2015.kpu.go.id/surabayakota/gunung_anyar/rungkut_menanggal
TPS 2,536,304,33,264,297,7,304,https://pilkada2015.kpu.go.id/surabayakota/gunung_anyar/rungkut_menanggal
TPS 3,513,309,40,261,301,8,309,https://pilkada2015.kpu.go.id/surabayakota/gunung_anyar/rungkut_menanggal
TPS 4,445,244,25,213,238,6,244,https://pilkada2015.kpu.go.id/surabayakota/gunung_anyar/rungkut_menanggal
TPS 5,513,284,31,253,284,0,284,https://pilkada2015.kpu.go.id/surabayakota/gunung_anyar/rungkut_menanggal
TPS 6,410,244,26,216,242,2,244,https://pilkada2015.kpu.go.id/surabayakota/gunung_anyar/rungkut_menanggal
TPS 7,525,309,37,267,304,5,309,https://pilkada2015.kpu.go.id/surabayakota/gunung_anyar/rungkut_menanggal
TPS 8,479,257,45,210,255,2,257,https://pilkada2015.kpu.go.id/surabayakota/gunung_anyar/rungkut_menanggal
TPS 9,543,303,37,260,297,6,303,https://pilkada2015.kpu.go.id/surabayakota/gunung_anyar/rungkut_menanggal
TPS 10,492,315,22,288,310,5,315,https://pilkada2015.kpu.go.id/surabayakota/gunung_anyar/rungkut_menanggal
TPS 11,408,268,31,230,261,7,268,https://pilkada2015.kpu.go.id/surabayakota/gunung_anyar/rungkut_menanggal
TPS 12,367,264,27,233,260,4,264,https://pilkada2015.kpu.go.id/surabayakota/gunung_anyar/rungkut_menanggal
TPS 13,441,280,41,236,277,3,280,https://pilkada2015.kpu.go.id/surabayakota/gunung_anyar/rungkut_menanggal
TPS 14,318,318,36,279,315,3,318,https://pilkada2015.kpu.go.id/surabayakota/gunung_anyar/rungkut_menanggal
TPS 15,302,302,45,251,296,6,302,https://pilkada2015.kpu.go.id/surabayakota/gunung_anyar/rungkut_menanggal
TPS 16,609,407,47,353,400,7,407,https://pilkada2015.kpu.go.id/surabayakota/gunung_anyar/rungkut_menanggal
TPS 17,577,323,47,271,318,5,323,https://pilkada2015.kpu.go.id/surabayakota/gunung_anyar/rungkut_menanggal
TPS 18,516,322,32,287,319,3,322,https://pilkada2015.kpu.go.id/surabayakota/gunung_anyar/rungkut_menanggal
TPS 1,673,392,53,333,386,6,392,https://pilkada2015.kpu.go.id/surabayakota/gunung_anyar/rungkut_tengah
TPS 2,604,364,47,314,361,3,364,https://pilkada2015.kpu.go.id/surabayakota/gunung_anyar/rungkut_tengah
TPS 3,632,0,22,305,327,5,332,https://pilkada2015.kpu.go.id/surabayakota/gunung_anyar/rungkut_tengah
TPS 4,756,426,37,382,419,7,426,https://pilkada2015.kpu.go.id/surabayakota/gunung_anyar/rungkut_tengah
TPS 5,557,319,24,290,314,5,319,https://pilkada2015.kpu.go.id/surabayakota/gunung_anyar/rungkut_tengah
TPS 6,625,352,27,316,343,9,352,https://pilkada2015.kpu.go.id/surabayakota/gunung_anyar/rungkut_tengah
TPS 7,367,203,25,174,199,4,203,https://pilkada2015.kpu.go.id/surabayakota/gunung_anyar/rungkut_tengah
TPS 8,596,373,49,316,365,8,373,https://pilkada2015.kpu.go.id/surabayakota/gunung_anyar/rungkut_tengah
TPS 9,535,336,44,289,333,3,336,https://pilkada2015.kpu.go.id/surabayakota/gunung_anyar/rungkut_tengah
TPS 10,386,224,16,204,220,4,224,https://pilkada2015.kpu.go.id/surabayakota/gunung_anyar/rungkut_tengah
TPS 11,406,234,20,214,234,0,234,https://pilkada2015.kpu.go.id/surabayakota/gunung_anyar/rungkut_tengah
TPS 12,305,155,12,142,154,1,155,https://pilkada2015.kpu.go.id/surabayakota/gunung_anyar/rungkut_tengah
TPS 13,346,196,9,183,192,4,196,https://pilkada2015.kpu.go.id/surabayakota/gunung_anyar/rungkut_tengah
TPS 14,708,335,30,304,334,1,335,https://pilkada2015.kpu.go.id/surabayakota/gunung_anyar/rungkut_tengah
TPS 15,371,207,22,184,206,1,207,https://pilkada2015.kpu.go.id/surabayakota/gunung_anyar/rungkut_tengah
TPS 16,392,215,17,197,214,1,215,https://pilkada2015.kpu.go.id/surabayakota/gunung_anyar/rungkut_tengah
TPS 17,584,310,37,272,309,1,310,https://pilkada2015.kpu.go.id/surabayakota/gunung_anyar/rungkut_tengah
TPS 18,464,228,11,215,226,2,228,https://pilkada2015.kpu.go.id/surabayakota/gunung_anyar/rungkut_tengah
TPS 1,535,276,36,235,271,5,276,https://pilkada2015.kpu.go.id/surabayakota/jambangan/jambangan
TPS 2,481,295,43,242,285,10,295,https://pilkada2015.kpu.go.id/surabayakota/jambangan/jambangan
TPS 3,0,350,49,293,342,8,350,https://pilkada2015.kpu.go.id/surabayakota/jambangan/jambangan
TPS 4,517,332,43,281,324,8,332,https://pilkada2015.kpu.go.id/surabayakota/jambangan/jambangan
TPS 5,0,250,33,212,245,5,250,https://pilkada2015.kpu.go.id/surabayakota/jambangan/jambangan
TPS 6,384,220,26,190,216,4,220,https://pilkada2015.kpu.go.id/surabayakota/jambangan/jambangan
TPS 7,553,348,45,298,343,5,348,https://pilkada2015.kpu.go.id/surabayakota/jambangan/jambangan
TPS 8,0,272,30,236,266,6,272,https://pilkada2015.kpu.go.id/surabayakota/jambangan/jambangan
TPS 9,580,309,43,260,303,6,309,https://pilkada2015.kpu.go.id/surabayakota/jambangan/jambangan
TPS 10,367,240,40,196,236,4,240,https://pilkada2015.kpu.go.id/surabayakota/jambangan/jambangan
TPS 11,506,286,57,225,282,4,286,https://pilkada2015.kpu.go.id/surabayakota/jambangan/jambangan
TPS 12,704,446,65,375,440,6,446,https://pilkada2015.kpu.go.id/surabayakota/jambangan/jambangan
TPS 13,617,305,51,253,304,1,305,https://pilkada2015.kpu.go.id/surabayakota/jambangan/jambangan
TPS 1,561,355,41,304,345,10,355,https://pilkada2015.kpu.go.id/surabayakota/jambangan/karah
TPS 2,547,313,55,254,309,4,313,https://pilkada2015.kpu.go.id/surabayakota/jambangan/karah
TPS 3,402,241,26,212,238,3,241,https://pilkada2015.kpu.go.id/surabayakota/jambangan/karah
TPS 4,460,281,54,222,276,5,281,https://pilkada2015.kpu.go.id/surabayakota/jambangan/karah
TPS 5,517,299,31,265,296,3,299,https://pilkada2015.kpu.go.id/surabayakota/jambangan/karah
TPS 6,400,200,37,161,198,2,200,https://pilkada2015.kpu.go.id/surabayakota/jambangan/karah
TPS 7,774,368,46,310,356,12,368,https://pilkada2015.kpu.go.id/surabayakota/jambangan/karah
TPS 8,684,441,43,386,429,12,441,https://pilkada2015.kpu.go.id/surabayakota/jambangan/karah
TPS 9,552,322,44,274,318,4,322,https://pilkada2015.kpu.go.id/surabayakota/jambangan/karah
TPS 10,433,303,35,261,296,7,303,https://pilkada2015.kpu.go.id/surabayakota/jambangan/karah
TPS 11,542,348,56,281,337,11,348,https://pilkada2015.kpu.go.id/surabayakota/jambangan/karah
TPS 12,509,306,31,273,304,2,306,https://pilkada2015.kpu.go.id/surabayakota/jambangan/karah
TPS 13,637,391,44,342,386,5,391,https://pilkada2015.kpu.go.id/surabayakota/jambangan/karah
TPS 14,776,486,70,410,480,6,486,https://pilkada2015.kpu.go.id/surabayakota/jambangan/karah
TPS 15,327,159,32,126,158,1,159,https://pilkada2015.kpu.go.id/surabayakota/jambangan/karah
TPS 16,547,363,61,296,357,6,363,https://pilkada2015.kpu.go.id/surabayakota/jambangan/karah
TPS 17,659,375,51,318,369,6,375,https://pilkada2015.kpu.go.id/surabayakota/jambangan/karah
TPS 18,416,236,45,188,233,3,236,https://pilkada2015.kpu.go.id/surabayakota/jambangan/karah
TPS 19,492,323,46,276,322,1,323,https://pilkada2015.kpu.go.id/surabayakota/jambangan/karah
TPS 20,293,148,17,131,148,0,148,https://pilkada2015.kpu.go.id/surabayakota/jambangan/karah
TPS 1,638,378,38,337,375,3,378,https://pilkada2015.kpu.go.id/surabayakota/jambangan/kebonsari
TPS 2,504,307,40,262,302,5,307,https://pilkada2015.kpu.go.id/surabayakota/jambangan/kebonsari
TPS 3,607,321,30,282,312,9,321,https://pilkada2015.kpu.go.id/surabayakota/jambangan/kebonsari
TPS 4,694,388,44,342,386,2,388,https://pilkada2015.kpu.go.id/surabayakota/jambangan/kebonsari
TPS 5,697,403,58,338,396,7,403,https://pilkada2015.kpu.go.id/surabayakota/jambangan/kebonsari
TPS 6,652,367,40,321,361,6,367,https://pilkada2015.kpu.go.id/surabayakota/jambangan/kebonsari
TPS 7,343,224,25,197,222,2,224,https://pilkada2015.kpu.go.id/surabayakota/jambangan/kebonsari
TPS 8,448,311,34,270,304,7,311,https://pilkada2015.kpu.go.id/surabayakota/jambangan/kebonsari
TPS 9,496,283,31,251,282,1,283,https://pilkada2015.kpu.go.id/surabayakota/jambangan/kebonsari
TPS 10,682,362,45,314,359,3,362,https://pilkada2015.kpu.go.id/surabayakota/jambangan/kebonsari
TPS 11,520,334,41,289,330,4,334,https://pilkada2015.kpu.go.id/surabayakota/jambangan/kebonsari
TPS 12,520,274,33,238,271,3,274,https://pilkada2015.kpu.go.id/surabayakota/jambangan/kebonsari
TPS 13,531,313,31,276,307,6,313,https://pilkada2015.kpu.go.id/surabayakota/jambangan/kebonsari
TPS 1,592,367,132,331,363,4,367,https://pilkada2015.kpu.go.id/surabayakota/jambangan/pagesangan
TPS 2,487,324,34,282,316,8,324,https://pilkada2015.kpu.go.id/surabayakota/jambangan/pagesangan
TPS 3,583,351,51,293,344,7,351,https://pilkada2015.kpu.go.id/surabayakota/jambangan/pagesangan
TPS 4,627,376,40,334,374,2,376,https://pilkada2015.kpu.go.id/surabayakota/jambangan/pagesangan
TPS 5,596,336,39,290,329,7,336,https://pilkada2015.kpu.go.id/surabayakota/jambangan/pagesangan
TPS 6,393,197,30,167,197,0,197,https://pilkada2015.kpu.go.id/surabayakota/jambangan/pagesangan
TPS 7,638,395,54,333,387,8,395,https://pilkada2015.kpu.go.id/surabayakota/jambangan/pagesangan
TPS 8,468,280,22,249,271,9,280,https://pilkada2015.kpu.go.id/surabayakota/jambangan/pagesangan
TPS 9,467,288,64,223,287,1,288,https://pilkada2015.kpu.go.id/surabayakota/jambangan/pagesangan
TPS 10,505,242,25,212,237,5,242,https://pilkada2015.kpu.go.id/surabayakota/jambangan/pagesangan
TPS 11,571,368,47,316,363,5,368,https://pilkada2015.kpu.go.id/surabayakota/jambangan/pagesangan
TPS 12,454,271,39,228,267,4,271,https://pilkada2015.kpu.go.id/surabayakota/jambangan/pagesangan
TPS 13,562,304,43,255,298,6,304,https://pilkada2015.kpu.go.id/surabayakota/jambangan/pagesangan
TPS 14,595,395,66,323,389,6,395,https://pilkada2015.kpu.go.id/surabayakota/jambangan/pagesangan
TPS 15,480,286,25,256,281,5,286,https://pilkada2015.kpu.go.id/surabayakota/jambangan/pagesangan
TPS 16,574,328,59,258,317,11,328,https://pilkada2015.kpu.go.id/surabayakota/jambangan/pagesangan
TPS 17,330,171,29,141,170,1,171,https://pilkada2015.kpu.go.id/surabayakota/jambangan/pagesangan
TPS 18,398,187,26,160,186,1,187,https://pilkada2015.kpu.go.id/surabayakota/jambangan/pagesangan
TPS 1,493,251,37,214,251,0,251,https://pilkada2015.kpu.go.id/surabayakota/karangpilang/karangpilang
TPS 2,513,336,42,289,331,5,336,https://pilkada2015.kpu.go.id/surabayakota/karangpilang/karangpilang
TPS 3,643,304,16,287,303,1,304,https://pilkada2015.kpu.go.id/surabayakota/karangpilang/karangpilang
TPS 4,483,304,31,271,302,2,304,https://pilkada2015.kpu.go.id/surabayakota/karangpilang/karangpilang
TPS 5,406,237,23,206,229,8,237,https://pilkada2015.kpu.go.id/surabayakota/karangpilang/karangpilang
TPS 6,620,307,54,244,298,9,307,https://pilkada2015.kpu.go.id/surabayakota/karangpilang/karangpilang
TPS 7,575,324,53,262,315,9,324,https://pilkada2015.kpu.go.id/surabayakota/karangpilang/karangpilang
TPS 8,523,206,40,164,204,2,206,https://pilkada2015.kpu.go.id/surabayakota/karangpilang/karangpilang
TPS 9,396,236,37,192,229,7,236,https://pilkada2015.kpu.go.id/surabayakota/karangpilang/karangpilang
TPS 10,408,233,30,196,226,7,233,https://pilkada2015.kpu.go.id/surabayakota/karangpilang/karangpilang
TPS 11,429,281,40,238,278,3,281,https://pilkada2015.kpu.go.id/surabayakota/karangpilang/karangpilang
TPS 12,476,273,39,227,266,7,273,https://pilkada2015.kpu.go.id/surabayakota/karangpilang/karangpilang
TPS 1,769,421,58,356,414,7,421,https://pilkada2015.kpu.go.id/surabayakota/karangpilang/kebraon
TPS 2,659,367,40,321,361,6,367,https://pilkada2015.kpu.go.id/surabayakota/karangpilang/kebraon
TPS 3,675,337,67,265,332,5,337,https://pilkada2015.kpu.go.id/surabayakota/karangpilang/kebraon
TPS 4,263,139,9,129,138,1,139,https://pilkada2015.kpu.go.id/surabayakota/karangpilang/kebraon
TPS 5,562,337,41,290,331,6,337,https://pilkada2015.kpu.go.id/surabayakota/karangpilang/kebraon
TPS 6,670,419,58,356,414,5,419,https://pilkada2015.kpu.go.id/surabayakota/karangpilang/kebraon
TPS 7,511,343,46,294,340,3,343,https://pilkada2015.kpu.go.id/surabayakota/karangpilang/kebraon
TPS 8,486,296,38,256,294,2,296,https://pilkada2015.kpu.go.id/surabayakota/karangpilang/kebraon
TPS 9,658,0,48,310,358,4,362,https://pilkada2015.kpu.go.id/surabayakota/karangpilang/kebraon
TPS 10,481,274,37,232,269,5,274,https://pilkada2015.kpu.go.id/surabayakota/karangpilang/kebraon
TPS 11,464,264,23,241,264,0,264,https://pilkada2015.kpu.go.id/surabayakota/karangpilang/kebraon
TPS 12,572,323,86,228,314,9,223,https://pilkada2015.kpu.go.id/surabayakota/karangpilang/kebraon
TPS 13,302,180,45,134,179,1,180,https://pilkada2015.kpu.go.id/surabayakota/karangpilang/kebraon
TPS 14,371,229,37,189,226,3,229,https://pilkada2015.kpu.go.id/surabayakota/karangpilang/kebraon
TPS 15,506,277,40,233,273,4,277,https://pilkada2015.kpu.go.id/surabayakota/karangpilang/kebraon
TPS 16,556,316,28,280,488,8,496,https://pilkada2015.kpu.go.id/surabayakota/karangpilang/kebraon
TPS 17,654,384,54,326,380,4,384,https://pilkada2015.kpu.go.id/surabayakota/karangpilang/kebraon
TPS 18,533,257,36,217,253,4,257,https://pilkada2015.kpu.go.id/surabayakota/karangpilang/kebraon
TPS 19,602,418,57,358,415,3,418,https://pilkada2015.kpu.go.id/surabayakota/karangpilang/kebraon
TPS 20,523,325,52,267,319,6,325,https://pilkada2015.kpu.go.id/surabayakota/karangpilang/kebraon
TPS 21,582,379,60,310,370,9,379,https://pilkada2015.kpu.go.id/surabayakota/karangpilang/kebraon
TPS 22,548,285,46,236,282,3,285,https://pilkada2015.kpu.go.id/surabayakota/karangpilang/kebraon
TPS 23,262,165,20,141,161,4,165,https://pilkada2015.kpu.go.id/surabayakota/karangpilang/kebraon
TPS 24,289,6,141,161,0,0,0,https://pilkada2015.kpu.go.id/surabayakota/karangpilang/kebraon
TPS 25,475,272,55,214,269,3,272,https://pilkada2015.kpu.go.id/surabayakota/karangpilang/kebraon
TPS 26,298,209,15,193,208,1,209,https://pilkada2015.kpu.go.id/surabayakota/karangpilang/kebraon
TPS 27,473,271,36,234,270,1,271,https://pilkada2015.kpu.go.id/surabayakota/karangpilang/kebraon
TPS 28,565,324,38,284,322,2,324,https://pilkada2015.kpu.go.id/surabayakota/karangpilang/kebraon
TPS 29,604,275,34,238,272,3,275,https://pilkada2015.kpu.go.id/surabayakota/karangpilang/kebraon
TPS 30,539,307,50,253,303,4,307,https://pilkada2015.kpu.go.id/surabayakota/karangpilang/kebraon
TPS 31,485,309,47,257,304,5,309,https://pilkada2015.kpu.go.id/surabayakota/karangpilang/kebraon
TPS 32,653,385,46,337,383,2,385,https://pilkada2015.kpu.go.id/surabayakota/karangpilang/kebraon
TPS 33,634,343,47,292,339,4,343,https://pilkada2015.kpu.go.id/surabayakota/karangpilang/kebraon
TPS 34,583,335,38,292,330,5,335,https://pilkada2015.kpu.go.id/surabayakota/karangpilang/kebraon
TPS 35,702,319,30,286,316,3,319,https://pilkada2015.kpu.go.id/surabayakota/karangpilang/kebraon
TPS 36,379,266,43,223,266,0,266,https://pilkada2015.kpu.go.id/surabayakota/karangpilang/kebraon
TPS 37,367,241,21,219,240,1,241,https://pilkada2015.kpu.go.id/surabayakota/karangpilang/kebraon
TPS 1,286,286,23,262,285,1,286,https://pilkada2015.kpu.go.id/surabayakota/karangpilang/kedurus
TPS 2,552,258,30,224,254,4,258,https://pilkada2015.kpu.go.id/surabayakota/karangpilang/kedurus
TPS 3,497,236,30,201,231,5,236,https://pilkada2015.kpu.go.id/surabayakota/karangpilang/kedurus
TPS 4,513,251,17,233,250,1,251,https://pilkada2015.kpu.go.id/surabayakota/karangpilang/kedurus
TPS 5,649,346,53,286,339,7,346,https://pilkada2015.kpu.go.id/surabayakota/karangpilang/kedurus
TPS 6,653,320,51,267,318,10,328,https://pilkada2015.kpu.go.id/surabayakota/karangpilang/kedurus
TPS 7,654,327,51,264,315,12,327,https://pilkada2015.kpu.go.id/surabayakota/karangpilang/kedurus
TPS 8,672,333,61,262,333,323,10,https://pilkada2015.kpu.go.id/surabayakota/karangpilang/kedurus
TPS 9,482,283,83,191,274,9,283,https://pilkada2015.kpu.go.id/surabayakota/karangpilang/kedurus
TPS 10,520,265,48,211,259,6,265,https://pilkada2015.kpu.go.id/surabayakota/karangpilang/kedurus
TPS 11,488,294,56,235,291,3,294,https://pilkada2015.kpu.go.id/surabayakota/karangpilang/kedurus
TPS 12,522,294,41,245,286,8,294,https://pilkada2015.kpu.go.id/surabayakota/karangpilang/kedurus
TPS 13,508,302,38,257,295,7,302,https://pilkada2015.kpu.go.id/surabayakota/karangpilang/kedurus
TPS 14,497,238,19,214,233,5,238,https://pilkada2015.kpu.go.id/surabayakota/karangpilang/kedurus
TPS 15,523,283,35,243,278,5,283,https://pilkada2015.kpu.go.id/surabayakota/karangpilang/kedurus
TPS 16,544,309,28,271,299,10,309,https://pilkada2015.kpu.go.id/surabayakota/karangpilang/kedurus
TPS 17,520,302,56,235,291,11,302,https://pilkada2015.kpu.go.id/surabayakota/karangpilang/kedurus
TPS 18,516,290,41,245,286,4,290,https://pilkada2015.kpu.go.id/surabayakota/karangpilang/kedurus
TPS 19,509,298,40,254,294,4,298,https://pilkada2015.kpu.go.id/surabayakota/karangpilang/kedurus
TPS 20,515,293,27,256,283,10,293,https://pilkada2015.kpu.go.id/surabayakota/karangpilang/kedurus
TPS 21,518,290,35,251,286,4,290,https://pilkada2015.kpu.go.id/surabayakota/karangpilang/kedurus
TPS 22,499,321,54,265,319,2,321,https://pilkada2015.kpu.go.id/surabayakota/karangpilang/kedurus
TPS 23,541,279,47,229,276,3,279,https://pilkada2015.kpu.go.id/surabayakota/karangpilang/kedurus
TPS 24,549,343,39,293,332,11,343,https://pilkada2015.kpu.go.id/surabayakota/karangpilang/kedurus
TPS 25,505,306,69,236,305,1,306,https://pilkada2015.kpu.go.id/surabayakota/karangpilang/kedurus
TPS 26,527,268,31,234,265,3,268,https://pilkada2015.kpu.go.id/surabayakota/karangpilang/kedurus
TPS 27,519,339,43,291,334,5,339,https://pilkada2015.kpu.go.id/surabayakota/karangpilang/kedurus
TPS 28,618,378,39,336,375,3,378,https://pilkada2015.kpu.go.id/surabayakota/karangpilang/kedurus
TPS 29,648,374,54,313,367,7,374,https://pilkada2015.kpu.go.id/surabayakota/karangpilang/kedurus
TPS 30,609,321,39,275,314,7,321,https://pilkada2015.kpu.go.id/surabayakota/karangpilang/kedurus
TPS 31,588,329,51,274,325,4,329,https://pilkada2015.kpu.go.id/surabayakota/karangpilang/kedurus
TPS 32,657,356,33,319,352,4,356,https://pilkada2015.kpu.go.id/surabayakota/karangpilang/kedurus
TPS 33,652,320,52,264,316,4,320,https://pilkada2015.kpu.go.id/surabayakota/karangpilang/kedurus
TPS 34,456,278,34,242,276,2,278,https://pilkada2015.kpu.go.id/surabayakota/karangpilang/kedurus
TPS 1,599,330,39,289,328,2,330,https://pilkada2015.kpu.go.id/surabayakota/karangpilang/warugunung
TPS 2,507,296,42,239,281,15,296,https://pilkada2015.kpu.go.id/surabayakota/karangpilang/warugunung
TPS 3,470,281,68,205,273,8,281,https://pilkada2015.kpu.go.id/surabayakota/karangpilang/warugunung
TPS 4,501,310,42,264,306,4,310,https://pilkada2015.kpu.go.id/surabayakota/karangpilang/warugunung
TPS 5,594,324,38,282,320,4,324,https://pilkada2015.kpu.go.id/surabayakota/karangpilang/warugunung
TPS 6,613,358,60,285,345,13,358,https://pilkada2015.kpu.go.id/surabayakota/karangpilang/warugunung
TPS 7,611,391,50,326,376,15,391,https://pilkada2015.kpu.go.id/surabayakota/karangpilang/warugunung
TPS 8,599,345,58,282,340,5,345,https://pilkada2015.kpu.go.id/surabayakota/karangpilang/warugunung
TPS 9,603,362,38,314,352,10,362,https://pilkada2015.kpu.go.id/surabayakota/karangpilang/warugunung
TPS 10,547,314,57,252,309,5,314,https://pilkada2015.kpu.go.id/surabayakota/karangpilang/warugunung
TPS 11,570,370,67,295,362,8,370,https://pilkada2015.kpu.go.id/surabayakota/karangpilang/warugunung
TPS 1,471,277,28,242,270,7,277,https://pilkada2015.kpu.go.id/surabayakota/kenjeran/bulak_banteng
TPS 2,522,278,27,247,274,4,278,https://pilkada2015.kpu.go.id/surabayakota/kenjeran/bulak_banteng
TPS 3,566,226,34,185,219,7,226,https://pilkada2015.kpu.go.id/surabayakota/kenjeran/bulak_banteng
TPS 4,452,260,27,227,254,6,260,https://pilkada2015.kpu.go.id/surabayakota/kenjeran/bulak_banteng
TPS 5,253,533,28,221,253,4,257,https://pilkada2015.kpu.go.id/surabayakota/kenjeran/bulak_banteng
TPS 6,601,164,19,144,163,1,164,https://pilkada2015.kpu.go.id/surabayakota/kenjeran/bulak_banteng
TPS 7,404,256,18,232,250,6,256,https://pilkada2015.kpu.go.id/surabayakota/kenjeran/bulak_banteng
TPS 8,451,237,26,208,234,3,237,https://pilkada2015.kpu.go.id/surabayakota/kenjeran/bulak_banteng
TPS 9,491,248,24,222,246,2,248,https://pilkada2015.kpu.go.id/surabayakota/kenjeran/bulak_banteng
TPS 10,729,484,37,437,474,10,484,https://pilkada2015.kpu.go.id/surabayakota/kenjeran/bulak_banteng
TPS 11,439,439,20,173,193,4,197,https://pilkada2015.kpu.go.id/surabayakota/kenjeran/bulak_banteng
TPS 12,515,234,31,201,232,2,232,https://pilkada2015.kpu.go.id/surabayakota/kenjeran/bulak_banteng
TPS 13,445,282,28,253,281,1,282,https://pilkada2015.kpu.go.id/surabayakota/kenjeran/bulak_banteng
TPS 14,419,267,14,251,265,2,267,https://pilkada2015.kpu.go.id/surabayakota/kenjeran/bulak_banteng
TPS 15,545,269,60,200,260,9,269,https://pilkada2015.kpu.go.id/surabayakota/kenjeran/bulak_banteng
TPS 16,560,252,36,213,249,3,252,https://pilkada2015.kpu.go.id/surabayakota/kenjeran/bulak_banteng
TPS 17,510,169,31,132,163,6,169,https://pilkada2015.kpu.go.id/surabayakota/kenjeran/bulak_banteng
TPS 18,619,229,44,181,225,4,229,https://pilkada2015.kpu.go.id/surabayakota/kenjeran/bulak_banteng
TPS 19,598,179,20,156,176,3,179,https://pilkada2015.kpu.go.id/surabayakota/kenjeran/bulak_banteng
TPS 20,594,211,26,184,210,1,211,https://pilkada2015.kpu.go.id/surabayakota/kenjeran/bulak_banteng
TPS 21,633,247,37,206,243,4,247,https://pilkada2015.kpu.go.id/surabayakota/kenjeran/bulak_banteng
TPS 22,628,628,29,188,217,5,227,https://pilkada2015.kpu.go.id/surabayakota/kenjeran/bulak_banteng
TPS 23,567,240,50,183,233,7,240,https://pilkada2015.kpu.go.id/surabayakota/kenjeran/bulak_banteng
TPS 24,514,235,35,198,233,2,235,https://pilkada2015.kpu.go.id/surabayakota/kenjeran/bulak_banteng
TPS 25,416,200,48,150,198,2,200,https://pilkada2015.kpu.go.id/surabayakota/kenjeran/bulak_banteng
TPS 26,536,208,26,179,205,3,208,https://pilkada2015.kpu.go.id/surabayakota/kenjeran/bulak_banteng
TPS 27,514,241,36,200,236,5,241,https://pilkada2015.kpu.go.id/surabayakota/kenjeran/bulak_banteng
TPS 28,554,210,19,187,206,4,210,https://pilkada2015.kpu.go.id/surabayakota/kenjeran/bulak_banteng
TPS 29,772,365,54,306,360,5,365,https://pilkada2015.kpu.go.id/surabayakota/kenjeran/bulak_banteng
TPS 30,491,188,35,153,188,0,188,https://pilkada2015.kpu.go.id/surabayakota/kenjeran/bulak_banteng
TPS 31,491,267,36,226,262,5,267,https://pilkada2015.kpu.go.id/surabayakota/kenjeran/bulak_banteng
TPS 32,439,219,28,188,216,3,219,https://pilkada2015.kpu.go.id/surabayakota/kenjeran/bulak_banteng
TPS 33,488,220,24,195,219,1,220,https://pilkada2015.kpu.go.id/surabayakota/kenjeran/bulak_banteng
TPS 34,497,192,15,176,191,1,192,https://pilkada2015.kpu.go.id/surabayakota/kenjeran/bulak_banteng
TPS 35,483,275,29,237,266,9,275,https://pilkada2015.kpu.go.id/surabayakota/kenjeran/bulak_banteng
TPS 36,523,263,43,214,257,6,263,https://pilkada2015.kpu.go.id/surabayakota/kenjeran/bulak_banteng
TPS 37,513,225,37,184,221,4,225,https://pilkada2015.kpu.go.id/surabayakota/kenjeran/bulak_banteng
TPS 1,552,267,20,237,257,10,267,https://pilkada2015.kpu.go.id/surabayakota/kenjeran/sidotopo_wetan
TPS 2,506,289,55,232,287,2,289,https://pilkada2015.kpu.go.id/surabayakota/kenjeran/sidotopo_wetan
TPS 3,468,245,28,212,240,5,245,https://pilkada2015.kpu.go.id/surabayakota/kenjeran/sidotopo_wetan
TPS 4,453,250,31,215,246,4,250,https://pilkada2015.kpu.go.id/surabayakota/kenjeran/sidotopo_wetan
TPS 5,483,206,56,145,201,5,206,https://pilkada2015.kpu.go.id/surabayakota/kenjeran/sidotopo_wetan
TPS 6,568,278,30,242,272,6,278,https://pilkada2015.kpu.go.id/surabayakota/kenjeran/sidotopo_wetan
TPS 7,663,316,44,264,308,8,316,https://pilkada2015.kpu.go.id/surabayakota/kenjeran/sidotopo_wetan
TPS 8,658,357,27,323,350,7,357,https://pilkada2015.kpu.go.id/surabayakota/kenjeran/sidotopo_wetan
TPS 9,593,249,22,224,246,3,249,https://pilkada2015.kpu.go.id/surabayakota/kenjeran/sidotopo_wetan
TPS 10,279,279,43,231,274,5,279,https://pilkada2015.kpu.go.id/surabayakota/kenjeran/sidotopo_wetan
TPS 11,605,190,19,168,187,3,190,https://pilkada2015.kpu.go.id/surabayakota/kenjeran/sidotopo_wetan
TPS 12,203,203,27,172,199,4,203,https://pilkada2015.kpu.go.id/surabayakota/kenjeran/sidotopo_wetan
TPS 13,501,243,24,216,240,3,243,https://pilkada2015.kpu.go.id/surabayakota/kenjeran/sidotopo_wetan
TPS 14,461,158,14,143,157,1,158,https://pilkada2015.kpu.go.id/surabayakota/kenjeran/sidotopo_wetan
TPS 15,510,215,15,193,208,7,215,https://pilkada2015.kpu.go.id/surabayakota/kenjeran/sidotopo_wetan
TPS 16,657,276,26,243,269,7,276,https://pilkada2015.kpu.go.id/surabayakota/kenjeran/sidotopo_wetan
TPS 17,509,224,26,193,219,5,224,https://pilkada2015.kpu.go.id/surabayakota/kenjeran/sidotopo_wetan
TPS 18,493,233,19,213,232,1,233,https://pilkada2015.kpu.go.id/surabayakota/kenjeran/sidotopo_wetan
TPS 19,426,165,15,149,164,1,165,https://pilkada2015.kpu.go.id/surabayakota/kenjeran/sidotopo_wetan
TPS 20,540,250,25,223,248,2,250,https://pilkada2015.kpu.go.id/surabayakota/kenjeran/sidotopo_wetan
TPS 21,238,238,16,220,236,2,238,https://pilkada2015.kpu.go.id/surabayakota/kenjeran/sidotopo_wetan
TPS 22,464,250,18,230,248,2,250,https://pilkada2015.kpu.go.id/surabayakota/kenjeran/sidotopo_wetan
TPS 23,503,339,22,316,338,1,339,https://pilkada2015.kpu.go.id/surabayakota/kenjeran/sidotopo_wetan
TPS 24,546,248,10,236,246,2,248,https://pilkada2015.kpu.go.id/surabayakota/kenjeran/sidotopo_wetan
TPS 25,450,222,20,201,221,1,222,https://pilkada2015.kpu.go.id/surabayakota/kenjeran/sidotopo_wetan
TPS 26,493,295,22,269,291,4,295,https://pilkada2015.kpu.go.id/surabayakota/kenjeran/sidotopo_wetan
TPS 27,518,269,30,233,263,6,269,https://pilkada2015.kpu.go.id/surabayakota/kenjeran/sidotopo_wetan
TPS 28,485,276,33,270,273,3,276,https://pilkada2015.kpu.go.id/surabayakota/kenjeran/sidotopo_wetan
TPS 29,478,251,25,226,251,0,251,https://pilkada2015.kpu.go.id/surabayakota/kenjeran/sidotopo_wetan
TPS 30,370,214,24,187,211,3,214,https://pilkada2015.kpu.go.id/surabayakota/kenjeran/sidotopo_wetan
TPS 31,448,240,21,217,238,2,240,https://pilkada2015.kpu.go.id/surabayakota/kenjeran/sidotopo_wetan
TPS 32,457,224,18,203,0,0,224,https://pilkada2015.kpu.go.id/surabayakota/kenjeran/sidotopo_wetan
TPS 33,524,294,40,248,288,6,294,https://pilkada2015.kpu.go.id/surabayakota/kenjeran/sidotopo_wetan
TPS 34,431,222,13,204,217,5,222,https://pilkada2015.kpu.go.id/surabayakota/kenjeran/sidotopo_wetan
TPS 35,519,132,23,107,130,2,132,https://pilkada2015.kpu.go.id/surabayakota/kenjeran/sidotopo_wetan
TPS 36,539,124,19,100,119,5,124,https://pilkada2015.kpu.go.id/surabayakota/kenjeran/sidotopo_wetan
TPS 37,519,175,25,148,173,2,175,https://pilkada2015.kpu.go.id/surabayakota/kenjeran/sidotopo_wetan
TPS 38,611,221,43,175,218,3,221,https://pilkada2015.kpu.go.id/surabayakota/kenjeran/sidotopo_wetan
TPS 39,580,223,30,184,214,9,223,https://pilkada2015.kpu.go.id/surabayakota/kenjeran/sidotopo_wetan
TPS 40,459,179,24,151,175,4,179,https://pilkada2015.kpu.go.id/surabayakota/kenjeran/sidotopo_wetan
TPS 41,407,179,25,152,177,2,179,https://pilkada2015.kpu.go.id/surabayakota/kenjeran/sidotopo_wetan
TPS 42,407,148,37,105,142,6,148,https://pilkada2015.kpu.go.id/surabayakota/kenjeran/sidotopo_wetan
TPS 43,425,170,34,135,169,1,170,https://pilkada2015.kpu.go.id/surabayakota/kenjeran/sidotopo_wetan
TPS 44,408,153,24,128,152,1,153,https://pilkada2015.kpu.go.id/surabayakota/kenjeran/sidotopo_wetan
TPS 45,499,206,46,157,203,3,206,https://pilkada2015.kpu.go.id/surabayakota/kenjeran/sidotopo_wetan
TPS 46,548,282,89,186,275,7,282,https://pilkada2015.kpu.go.id/surabayakota/kenjeran/sidotopo_wetan
TPS 47,0,0,22,227,0,0,0,https://pilkada2015.kpu.go.id/surabayakota/kenjeran/sidotopo_wetan
TPS 48,524,223,67,155,222,1,223,https://pilkada2015.kpu.go.id/surabayakota/kenjeran/sidotopo_wetan
TPS 49,632,249,24,219,243,6,249,https://pilkada2015.kpu.go.id/surabayakota/kenjeran/sidotopo_wetan
TPS 50,0,0,34,181,0,0,0,https://pilkada2015.kpu.go.id/surabayakota/kenjeran/sidotopo_wetan
TPS 51,628,231,32,196,228,3,231,https://pilkada2015.kpu.go.id/surabayakota/kenjeran/sidotopo_wetan
TPS 52,646,258,34,217,251,7,258,https://pilkada2015.kpu.go.id/surabayakota/kenjeran/sidotopo_wetan
TPS 53,605,326,25,298,323,3,326,https://pilkada2015.kpu.go.id/surabayakota/kenjeran/sidotopo_wetan
TPS 54,548,274,31,239,270,4,274,https://pilkada2015.kpu.go.id/surabayakota/kenjeran/sidotopo_wetan
TPS 55,468,256,47,208,255,1,256,https://pilkada2015.kpu.go.id/surabayakota/kenjeran/sidotopo_wetan
TPS 56,482,224,27,196,223,1,224,https://pilkada2015.kpu.go.id/surabayakota/kenjeran/sidotopo_wetan
TPS 57,560,258,22,234,256,2,258,https://pilkada2015.kpu.go.id/surabayakota/kenjeran/sidotopo_wetan
TPS 58,545,207,31,172,203,4,207,https://pilkada2015.kpu.go.id/surabayakota/kenjeran/sidotopo_wetan
TPS 59,568,332,18,313,331,1,332,https://pilkada2015.kpu.go.id/surabayakota/kenjeran/sidotopo_wetan
TPS 60,448,216,23,191,214,2,216,https://pilkada2015.kpu.go.id/surabayakota/kenjeran/sidotopo_wetan
TPS 61,478,245,31,213,244,1,245,https://pilkada2015.kpu.go.id/surabayakota/kenjeran/sidotopo_wetan
TPS 62,462,250,19,225,244,6,250,https://pilkada2015.kpu.go.id/surabayakota/kenjeran/sidotopo_wetan
TPS 63,554,292,14,275,289,3,292,https://pilkada2015.kpu.go.id/surabayakota/kenjeran/sidotopo_wetan
TPS 64,521,282,31,250,281,1,282,https://pilkada2015.kpu.go.id/surabayakota/kenjeran/sidotopo_wetan
TPS 65,591,310,35,275,310,0,310,https://pilkada2015.kpu.go.id/surabayakota/kenjeran/sidotopo_wetan
TPS 66,455,242,17,225,242,0,242,https://pilkada2015.kpu.go.id/surabayakota/kenjeran/sidotopo_wetan
TPS 67,527,259,31,227,258,1,259,https://pilkada2015.kpu.go.id/surabayakota/kenjeran/sidotopo_wetan
TPS 68,197,197,15,177,192,5,197,https://pilkada2015.kpu.go.id/surabayakota/kenjeran/sidotopo_wetan
TPS 69,552,258,52,204,256,2,258,https://pilkada2015.kpu.go.id/surabayakota/kenjeran/sidotopo_wetan
TPS 70,539,157,24,125,149,8,157,https://pilkada2015.kpu.go.id/surabayakota/kenjeran/sidotopo_wetan
TPS 71,531,180,48,132,180,0,180,https://pilkada2015.kpu.go.id/surabayakota/kenjeran/sidotopo_wetan
TPS 72,557,245,44,197,241,4,245,https://pilkada2015.kpu.go.id/surabayakota/kenjeran/sidotopo_wetan
TPS 73,513,272,37,229,266,6,272,https://pilkada2015.kpu.go.id/surabayakota/kenjeran/sidotopo_wetan
TPS 1,568,258,41,212,253,5,258,https://pilkada2015.kpu.go.id/surabayakota/kenjeran/tambak_wedi
TPS 2,537,276,37,235,272,4,276,https://pilkada2015.kpu.go.id/surabayakota/kenjeran/tambak_wedi
TPS 3,589,277,48,225,273,4,277,https://pilkada2015.kpu.go.id/surabayakota/kenjeran/tambak_wedi
TPS 4,608,301,42,250,292,9,301,https://pilkada2015.kpu.go.id/surabayakota/kenjeran/tambak_wedi
TPS 5,556,203,39,160,199,4,203,https://pilkada2015.kpu.go.id/surabayakota/kenjeran/tambak_wedi
TPS 6,567,216,60,148,208,8,216,https://pilkada2015.kpu.go.id/surabayakota/kenjeran/tambak_wedi
TPS 7,521,195,35,155,190,5,195,https://pilkada2015.kpu.go.id/surabayakota/kenjeran/tambak_wedi
TPS 8,512,253,61,189,250,3,253,https://pilkada2015.kpu.go.id/surabayakota/kenjeran/tambak_wedi
TPS 9,544,544,41,188,229,6,235,https://pilkada2015.kpu.go.id/surabayakota/kenjeran/tambak_wedi
TPS 10,538,321,41,278,319,2,321,https://pilkada2015.kpu.go.id/surabayakota/kenjeran/tambak_wedi
TPS 11,481,278,27,251,278,1,279,https://pilkada2015.kpu.go.id/surabayakota/kenjeran/tambak_wedi
TPS 12,484,228,27,198,225,3,228,https://pilkada2015.kpu.go.id/surabayakota/kenjeran/tambak_wedi
TPS 13,481,212,37,167,204,8,212,https://pilkada2015.kpu.go.id/surabayakota/kenjeran/tambak_wedi
TPS 14,604,308,34,270,304,4,308,https://pilkada2015.kpu.go.id/surabayakota/kenjeran/tambak_wedi
TPS 15,607,334,34,294,328,6,334,https://pilkada2015.kpu.go.id/surabayakota/kenjeran/tambak_wedi
TPS 16,606,294,31,261,292,2,294,https://pilkada2015.kpu.go.id/surabayakota/kenjeran/tambak_wedi
TPS 17,588,221,21,196,217,4,221,https://pilkada2015.kpu.go.id/surabayakota/kenjeran/tambak_wedi
TPS 1,737,298,44,250,294,4,298,https://pilkada2015.kpu.go.id/surabayakota/kenjeran/tanah_kali_kedinding
TPS 2,601,294,38,246,284,10,294,https://pilkada2015.kpu.go.id/surabayakota/kenjeran/tanah_kali_kedinding
TPS 3,700,326,34,288,322,4,326,https://pilkada2015.kpu.go.id/surabayakota/kenjeran/tanah_kali_kedinding
TPS 4,586,280,34,244,278,2,280,https://pilkada2015.kpu.go.id/surabayakota/kenjeran/tanah_kali_kedinding
TPS 5,563,304,30,270,300,4,304,https://pilkada2015.kpu.go.id/surabayakota/kenjeran/tanah_kali_kedinding
TPS 6,572,342,26,311,337,5,342,https://pilkada2015.kpu.go.id/surabayakota/kenjeran/tanah_kali_kedinding
TPS 7,475,264,37,223,260,4,264,https://pilkada2015.kpu.go.id/surabayakota/kenjeran/tanah_kali_kedinding
TPS 8,710,345,49,293,342,3,345,https://pilkada2015.kpu.go.id/surabayakota/kenjeran/tanah_kali_kedinding
TPS 9,541,350,52,292,344,6,350,https://pilkada2015.kpu.go.id/surabayakota/kenjeran/tanah_kali_kedinding
TPS 10,522,317,24,290,314,3,317,https://pilkada2015.kpu.go.id/surabayakota/kenjeran/tanah_kali_kedinding
TPS 11,408,245,31,213,244,1,245,https://pilkada2015.kpu.go.id/surabayakota/kenjeran/tanah_kali_kedinding
TPS 12,540,338,37,298,335,3,338,https://pilkada2015.kpu.go.id/surabayakota/kenjeran/tanah_kali_kedinding
TPS 13,576,318,20,296,316,2,318,https://pilkada2015.kpu.go.id/surabayakota/kenjeran/tanah_kali_kedinding
TPS 14,610,357,24,328,352,5,357,https://pilkada2015.kpu.go.id/surabayakota/kenjeran/tanah_kali_kedinding
TPS 15,508,352,24,324,348,4,352,https://pilkada2015.kpu.go.id/surabayakota/kenjeran/tanah_kali_kedinding
TPS 16,533,323,30,289,319,4,323,https://pilkada2015.kpu.go.id/surabayakota/kenjeran/tanah_kali_kedinding
TPS 17,466,294,40,252,292,2,294,https://pilkada2015.kpu.go.id/surabayakota/kenjeran/tanah_kali_kedinding
TPS 18,491,303,39,257,296,7,303,https://pilkada2015.kpu.go.id/surabayakota/kenjeran/tanah_kali_kedinding
TPS 19,411,250,32,215,247,3,250,https://pilkada2015.kpu.go.id/surabayakota/kenjeran/tanah_kali_kedinding
TPS 20,447,279,23,250,273,6,279,https://pilkada2015.kpu.go.id/surabayakota/kenjeran/tanah_kali_kedinding
TPS 21,496,318,42,268,310,8,318,https://pilkada2015.kpu.go.id/surabayakota/kenjeran/tanah_kali_kedinding
TPS 22,375,209,22,181,203,6,209,https://pilkada2015.kpu.go.id/surabayakota/kenjeran/tanah_kali_kedinding
TPS 23,475,304,38,260,298,6,304,https://pilkada2015.kpu.go.id/surabayakota/kenjeran/tanah_kali_kedinding
TPS 24,568,327,29,288,317,10,327,https://pilkada2015.kpu.go.id/surabayakota/kenjeran/tanah_kali_kedinding
TPS 25,521,311,48,259,307,4,311,https://pilkada2015.kpu.go.id/surabayakota/kenjeran/tanah_kali_kedinding
TPS 26,445,294,29,257,286,8,294,https://pilkada2015.kpu.go.id/surabayakota/kenjeran/tanah_kali_kedinding
TPS 27,465,269,36,227,263,6,269,https://pilkada2015.kpu.go.id/surabayakota/kenjeran/tanah_kali_kedinding
TPS 28,478,285,33,244,277,8,285,https://pilkada2015.kpu.go.id/surabayakota/kenjeran/tanah_kali_kedinding
TPS 29,446,225,20,202,222,3,225,https://pilkada2015.kpu.go.id/surabayakota/kenjeran/tanah_kali_kedinding
TPS 30,437,289,38,248,286,3,289,https://pilkada2015.kpu.go.id/surabayakota/kenjeran/tanah_kali_kedinding
TPS 31,525,272,39,230,269,3,272,https://pilkada2015.kpu.go.id/surabayakota/kenjeran/tanah_kali_kedinding
TPS 32,472,307,39,264,303,4,307,https://pilkada2015.kpu.go.id/surabayakota/kenjeran/tanah_kali_kedinding
TPS 33,425,266,32,232,264,2,266,https://pilkada2015.kpu.go.id/surabayakota/kenjeran/tanah_kali_kedinding
TPS 34,514,262,20,239,259,3,262,https://pilkada2015.kpu.go.id/surabayakota/kenjeran/tanah_kali_kedinding
TPS 35,366,203,15,186,201,2,203,https://pilkada2015.kpu.go.id/surabayakota/kenjeran/tanah_kali_kedinding
TPS 36,659,409,50,358,408,1,409,https://pilkada2015.kpu.go.id/surabayakota/kenjeran/tanah_kali_kedinding
TPS 37,660,347,58,284,342,5,347,https://pilkada2015.kpu.go.id/surabayakota/kenjeran/tanah_kali_kedinding
TPS 38,407,256,34,217,251,5,256,https://pilkada2015.kpu.go.id/surabayakota/kenjeran/tanah_kali_kedinding
TPS 39,414,262,43,215,258,4,262,https://pilkada2015.kpu.go.id/surabayakota/kenjeran/tanah_kali_kedinding
TPS 40,609,341,42,293,335,6,341,https://pilkada2015.kpu.go.id/surabayakota/kenjeran/tanah_kali_kedinding
TPS 41,467,308,41,257,298,10,308,https://pilkada2015.kpu.go.id/surabayakota/kenjeran/tanah_kali_kedinding
TPS 42,748,425,63,359,422,3,425,https://pilkada2015.kpu.go.id/surabayakota/kenjeran/tanah_kali_kedinding
TPS 43,511,292,36,251,287,5,292,https://pilkada2015.kpu.go.id/surabayakota/kenjeran/tanah_kali_kedinding
TPS 44,700,398,45,347,392,6,398,https://pilkada2015.kpu.go.id/surabayakota/kenjeran/tanah_kali_kedinding
TPS 45,560,278,30,243,273,5,278,https://pilkada2015.kpu.go.id/surabayakota/kenjeran/tanah_kali_kedinding
TPS 46,459,270,49,218,267,3,270,https://pilkada2015.kpu.go.id/surabayakota/kenjeran/tanah_kali_kedinding
TPS 47,568,336,52,271,323,13,336,https://pilkada2015.kpu.go.id/surabayakota/kenjeran/tanah_kali_kedinding
TPS 48,466,251,42,202,244,7,251,https://pilkada2015.kpu.go.id/surabayakota/kenjeran/tanah_kali_kedinding
TPS 49,384,233,39,193,232,1,233,https://pilkada2015.kpu.go.id/surabayakota/kenjeran/tanah_kali_kedinding
TPS 50,313,185,28,157,185,0,185,https://pilkada2015.kpu.go.id/surabayakota/kenjeran/tanah_kali_kedinding
TPS 51,484,259,23,232,255,4,259,https://pilkada2015.kpu.go.id/surabayakota/kenjeran/tanah_kali_kedinding
TPS 52,488,240,18,219,237,3,240,https://pilkada2015.kpu.go.id/surabayakota/kenjeran/tanah_kali_kedinding
TPS 53,493,262,21,238,259,3,262,https://pilkada2015.kpu.go.id/surabayakota/kenjeran/tanah_kali_kedinding
TPS 54,378,210,52,155,207,3,210,https://pilkada2015.kpu.go.id/surabayakota/kenjeran/tanah_kali_kedinding
TPS 55,644,386,34,346,380,6,386,https://pilkada2015.kpu.go.id/surabayakota/kenjeran/tanah_kali_kedinding
TPS 56,405,231,32,196,228,3,231,https://pilkada2015.kpu.go.id/surabayakota/kenjeran/tanah_kali_kedinding
TPS 57,577,292,26,261,287,5,292,https://pilkada2015.kpu.go.id/surabayakota/kenjeran/tanah_kali_kedinding
TPS 58,500,261,31,226,257,4,261,https://pilkada2015.kpu.go.id/surabayakota/kenjeran/tanah_kali_kedinding
TPS 59,581,377,39,332,371,6,377,https://pilkada2015.kpu.go.id/surabayakota/kenjeran/tanah_kali_kedinding
TPS 60,512,349,21,324,345,4,349,https://pilkada2015.kpu.go.id/surabayakota/kenjeran/tanah_kali_kedinding
TPS 61,558,352,42,307,349,3,352,https://pilkada2015.kpu.go.id/surabayakota/kenjeran/tanah_kali_kedinding
TPS 62,408,264,30,231,261,3,264,https://pilkada2015.kpu.go.id/surabayakota/kenjeran/tanah_kali_kedinding
TPS 63,497,318,25,293,318,0,318,https://pilkada2015.kpu.go.id/surabayakota/kenjeran/tanah_kali_kedinding
TPS 64,308,211,22,186,208,3,211,https://pilkada2015.kpu.go.id/surabayakota/kenjeran/tanah_kali_kedinding
TPS 65,386,225,20,205,225,0,0,https://pilkada2015.kpu.go.id/surabayakota/kenjeran/tanah_kali_kedinding
TPS 1,482,233,65,163,228,5,233,https://pilkada2015.kpu.go.id/surabayakota/krembangan/dupak
TPS 2,481,264,48,211,259,5,264,https://pilkada2015.kpu.go.id/surabayakota/krembangan/dupak
TPS 3,526,243,42,191,233,10,243,https://pilkada2015.kpu.go.id/surabayakota/krembangan/dupak
TPS 4,457,208,25,176,201,6,207,https://pilkada2015.kpu.go.id/surabayakota/krembangan/dupak
TPS 5,0,254,27,224,251,3,254,https://pilkada2015.kpu.go.id/surabayakota/krembangan/dupak
TPS 6,494,249,25,220,245,4,249,https://pilkada2015.kpu.go.id/surabayakota/krembangan/dupak
TPS 7,582,263,35,221,256,7,263,https://pilkada2015.kpu.go.id/surabayakota/krembangan/dupak
TPS 8,548,208,26,182,208,0,208,https://pilkada2015.kpu.go.id/surabayakota/krembangan/dupak
TPS 9,424,213,28,176,204,9,213,https://pilkada2015.kpu.go.id/surabayakota/krembangan/dupak
TPS 10,471,278,44,227,271,7,278,https://pilkada2015.kpu.go.id/surabayakota/krembangan/dupak
TPS 11,218,218,23,194,217,1,218,https://pilkada2015.kpu.go.id/surabayakota/krembangan/dupak
TPS 12,609,323,36,283,319,4,323,https://pilkada2015.kpu.go.id/surabayakota/krembangan/dupak
TPS 13,539,287,42,239,281,6,287,https://pilkada2015.kpu.go.id/surabayakota/krembangan/dupak
TPS 14,394,235,57,173,230,5,235,https://pilkada2015.kpu.go.id/surabayakota/krembangan/dupak
TPS 15,496,254,55,198,253,1,254,https://pilkada2015.kpu.go.id/surabayakota/krembangan/dupak
TPS 16,373,260,49,206,255,5,260,https://pilkada2015.kpu.go.id/surabayakota/krembangan/dupak
TPS 17,490,265,29,229,258,7,265,https://pilkada2015.kpu.go.id/surabayakota/krembangan/dupak
TPS 18,490,277,37,235,272,5,277,https://pilkada2015.kpu.go.id/surabayakota/krembangan/dupak
TPS 19,532,254,39,211,250,4,254,https://pilkada2015.kpu.go.id/surabayakota/krembangan/dupak
TPS 20,530,298,70,223,293,5,298,https://pilkada2015.kpu.go.id/surabayakota/krembangan/dupak
TPS 21,514,237,40,187,227,10,237,https://pilkada2015.kpu.go.id/surabayakota/krembangan/dupak
TPS 22,449,246,40,197,237,9,246,https://pilkada2015.kpu.go.id/surabayakota/krembangan/dupak
TPS 23,457,281,32,240,272,9,281,https://pilkada2015.kpu.go.id/surabayakota/krembangan/dupak
TPS 24,457,252,36,212,248,4,252,https://pilkada2015.kpu.go.id/surabayakota/krembangan/dupak
TPS 25,414,243,45,195,240,3,243,https://pilkada2015.kpu.go.id/surabayakota/krembangan/dupak
TPS 26,516,344,44,295,339,5,344,https://pilkada2015.kpu.go.id/surabayakota/krembangan/dupak
TPS 27,497,277,51,219,270,7,277,https://pilkada2015.kpu.go.id/surabayakota/krembangan/dupak
TPS 28,418,268,50,211,261,7,268,https://pilkada2015.kpu.go.id/surabayakota/krembangan/dupak
TPS 29,403,244,46,194,240,4,240,https://pilkada2015.kpu.go.id/surabayakota/krembangan/dupak
TPS 30,278,278,31,239,270,8,278,https://pilkada2015.kpu.go.id/surabayakota/krembangan/dupak
TPS 31,374,374,42,160,202,8,210,https://pilkada2015.kpu.go.id/surabayakota/krembangan/dupak
TPS 32,374,268,46,217,263,5,268,https://pilkada2015.kpu.go.id/surabayakota/krembangan/dupak
TPS 33,317,185,46,137,183,2,185,https://pilkada2015.kpu.go.id/surabayakota/krembangan/dupak
TPS 34,334,247,37,208,245,2,247,https://pilkada2015.kpu.go.id/surabayakota/krembangan/dupak
TPS 1,609,248,18,227,245,3,248,https://pilkada2015.kpu.go.id/surabayakota/krembangan/kemayoran
TPS 2,437,243,21,218,239,4,243,https://pilkada2015.kpu.go.id/surabayakota/krembangan/kemayoran
TPS 3,537,251,26,217,243,8,251,https://pilkada2015.kpu.go.id/surabayakota/krembangan/kemayoran
TPS 4,580,224,21,201,222,2,224,https://pilkada2015.kpu.go.id/surabayakota/krembangan/kemayoran
TPS 5,512,239,18,216,234,5,239,https://pilkada2015.kpu.go.id/surabayakota/krembangan/kemayoran
TPS 6,583,292,28,261,289,3,292,https://pilkada2015.kpu.go.id/surabayakota/krembangan/kemayoran
TPS 7,671,331,30,296,326,5,331,https://pilkada2015.kpu.go.id/surabayakota/krembangan/kemayoran
TPS 8,532,244,30,212,242,2,244,https://pilkada2015.kpu.go.id/surabayakota/krembangan/kemayoran
TPS 9,367,197,27,167,194,3,197,https://pilkada2015.kpu.go.id/surabayakota/krembangan/kemayoran
TPS 10,583,266,50,211,261,5,266,https://pilkada2015.kpu.go.id/surabayakota/krembangan/kemayoran
TPS 11,534,288,34,249,283,5,288,https://pilkada2015.kpu.go.id/surabayakota/krembangan/kemayoran
TPS 12,517,249,20,218,238,11,249,https://pilkada2015.kpu.go.id/surabayakota/krembangan/kemayoran
TPS 13,0,248,31,209,240,8,248,https://pilkada2015.kpu.go.id/surabayakota/krembangan/kemayoran
TPS 14,544,221,38,178,216,5,221,https://pilkada2015.kpu.go.id/surabayakota/krembangan/kemayoran
TPS 15,287,287,26,259,285,2,287,https://pilkada2015.kpu.go.id/surabayakota/krembangan/kemayoran
TPS 16,512,282,30,248,278,4,282,https://pilkada2015.kpu.go.id/surabayakota/krembangan/kemayoran
TPS 17,632,277,51,221,272,5,277,https://pilkada2015.kpu.go.id/surabayakota/krembangan/kemayoran
TPS 18,662,269,59,202,261,8,269,https://pilkada2015.kpu.go.id/surabayakota/krembangan/kemayoran
TPS 19,214,214,28,182,210,4,214,https://pilkada2015.kpu.go.id/surabayakota/krembangan/kemayoran
TPS 20,424,175,16,158,174,1,175,https://pilkada2015.kpu.go.id/surabayakota/krembangan/kemayoran
TPS 21,523,193,36,155,191,2,193,https://pilkada2015.kpu.go.id/surabayakota/krembangan/kemayoran
TPS 22,355,177,23,150,173,4,177,https://pilkada2015.kpu.go.id/surabayakota/krembangan/kemayoran
TPS 23,440,202,50,148,198,0,202,https://pilkada2015.kpu.go.id/surabayakota/krembangan/kemayoran
TPS 24,698,247,55,187,242,5,247,https://pilkada2015.kpu.go.id/surabayakota/krembangan/kemayoran
TPS 25,736,287,62,222,284,3,287,https://pilkada2015.kpu.go.id/surabayakota/krembangan/kemayoran
TPS 26,305,123,12,110,122,1,123,https://pilkada2015.kpu.go.id/surabayakota/krembangan/kemayoran
TPS 1,537,308,200,101,301,7,308,https://pilkada2015.kpu.go.id/surabayakota/krembangan/krembangan_selatan
TPS 2,397,189,70,113,183,6,189,https://pilkada2015.kpu.go.id/surabayakota/krembangan/krembangan_selatan
TPS 3,481,237,88,146,234,3,237,https://pilkada2015.kpu.go.id/surabayakota/krembangan/krembangan_selatan
TPS 4,601,300,124,170,294,6,300,https://pilkada2015.kpu.go.id/surabayakota/krembangan/krembangan_selatan
TPS 5,469,260,55,202,257,3,260,https://pilkada2015.kpu.go.id/surabayakota/krembangan/krembangan_selatan
TPS 6,498,206,45,151,196,10,206,https://pilkada2015.kpu.go.id/surabayakota/krembangan/krembangan_selatan
TPS 7,462,217,40,173,213,4,217,https://pilkada2015.kpu.go.id/surabayakota/krembangan/krembangan_selatan
TPS 8,448,187,26,160,186,1,187,https://pilkada2015.kpu.go.id/surabayakota/krembangan/krembangan_selatan
TPS 9,681,296,39,254,293,3,296,https://pilkada2015.kpu.go.id/surabayakota/krembangan/krembangan_selatan
TPS 10,544,208,13,193,206,2,208,https://pilkada2015.kpu.go.id/surabayakota/krembangan/krembangan_selatan
TPS 11,459,247,44,199,243,4,247,https://pilkada2015.kpu.go.id/surabayakota/krembangan/krembangan_selatan
TPS 12,491,241,30,206,236,5,241,https://pilkada2015.kpu.go.id/surabayakota/krembangan/krembangan_selatan
TPS 13,565,267,50,207,257,10,267,https://pilkada2015.kpu.go.id/surabayakota/krembangan/krembangan_selatan
TPS 14,569,221,25,194,219,2,221,https://pilkada2015.kpu.go.id/surabayakota/krembangan/krembangan_selatan
TPS 15,581,225,20,204,224,1,225,https://pilkada2015.kpu.go.id/surabayakota/krembangan/krembangan_selatan
TPS 16,733,278,33,243,276,2,278,https://pilkada2015.kpu.go.id/surabayakota/krembangan/krembangan_selatan
TPS 17,486,206,21,185,206,0,206,https://pilkada2015.kpu.go.id/surabayakota/krembangan/krembangan_selatan
TPS 18,645,246,25,217,242,4,246,https://pilkada2015.kpu.go.id/surabayakota/krembangan/krembangan_selatan
TPS 19,689,257,43,211,254,3,257,https://pilkada2015.kpu.go.id/surabayakota/krembangan/krembangan_selatan
TPS 20,537,172,33,138,171,1,172,https://pilkada2015.kpu.go.id/surabayakota/krembangan/krembangan_selatan
TPS 21,631,222,26,193,219,3,222,https://pilkada2015.kpu.go.id/surabayakota/krembangan/krembangan_selatan
TPS 1,449,244,24,218,242,2,244,https://pilkada2015.kpu.go.id/surabayakota/krembangan/morokrembangan
TPS 2,460,277,19,255,274,3,277,https://pilkada2015.kpu.go.id/surabayakota/krembangan/morokrembangan
TPS 3,498,312,23,284,307,5,312,https://pilkada2015.kpu.go.id/surabayakota/krembangan/morokrembangan
TPS 4,498,275,23,250,273,2,275,https://pilkada2015.kpu.go.id/surabayakota/krembangan/morokrembangan
TPS 5,510,227,30,194,224,3,227,https://pilkada2015.kpu.go.id/surabayakota/krembangan/morokrembangan
TPS 6,354,218,24,191,215,3,218,https://pilkada2015.kpu.go.id/surabayakota/krembangan/morokrembangan
TPS 7,536,257,25,226,251,6,257,https://pilkada2015.kpu.go.id/surabayakota/krembangan/morokrembangan
TPS 8,457,247,16,228,244,3,247,https://pilkada2015.kpu.go.id/surabayakota/krembangan/morokrembangan
TPS 9,537,246,43,198,241,5,246,https://pilkada2015.kpu.go.id/surabayakota/krembangan/morokrembangan
TPS 10,599,270,39,226,265,5,270,https://pilkada2015.kpu.go.id/surabayakota/krembangan/morokrembangan
TPS 11,446,160,32,125,157,3,160,https://pilkada2015.kpu.go.id/surabayakota/krembangan/morokrembangan
TPS 12,595,377,48,325,373,4,377,https://pilkada2015.kpu.go.id/surabayakota/krembangan/morokrembangan
TPS 13,589,299,38,257,295,4,299,https://pilkada2015.kpu.go.id/surabayakota/krembangan/morokrembangan
TPS 14,468,245,29,214,243,2,245,https://pilkada2015.kpu.go.id/surabayakota/krembangan/morokrembangan
TPS 15,579,308,15,291,306,2,308,https://pilkada2015.kpu.go.id/surabayakota/krembangan/morokrembangan
TPS 16,627,302,27,270,297,5,302,https://pilkada2015.kpu.go.id/surabayakota/krembangan/morokrembangan
TPS 17,511,288,32,255,287,1,288,https://pilkada2015.kpu.go.id/surabayakota/krembangan/morokrembangan
TPS 18,440,317,16,297,313,4,317,https://pilkada2015.kpu.go.id/surabayakota/krembangan/morokrembangan
TPS 19,461,322,27,294,321,1,322,https://pilkada2015.kpu.go.id/surabayakota/krembangan/morokrembangan
TPS 20,517,321,44,273,317,4,321,https://pilkada2015.kpu.go.id/surabayakota/krembangan/morokrembangan
TPS 21,533,314,51,262,313,1,314,https://pilkada2015.kpu.go.id/surabayakota/krembangan/morokrembangan
TPS 22,469,229,49,178,227,2,229,https://pilkada2015.kpu.go.id/surabayakota/krembangan/morokrembangan
TPS 23,451,265,80,176,256,9,265,https://pilkada2015.kpu.go.id/surabayakota/krembangan/morokrembangan
TPS 24,451,231,71,159,230,1,231,https://pilkada2015.kpu.go.id/surabayakota/krembangan/morokrembangan
TPS 25,436,249,56,189,245,4,249,https://pilkada2015.kpu.go.id/surabayakota/krembangan/morokrembangan
TPS 26,484,216,53,160,213,3,216,https://pilkada2015.kpu.go.id/surabayakota/krembangan/morokrembangan
TPS 27,547,229,51,170,221,8,229,https://pilkada2015.kpu.go.id/surabayakota/krembangan/morokrembangan
TPS 28,547,252,53,197,250,2,252,https://pilkada2015.kpu.go.id/surabayakota/krembangan/morokrembangan
TPS 29,413,241,52,186,238,3,241,https://pilkada2015.kpu.go.id/surabayakota/krembangan/morokrembangan
TPS 30,401,272,34,233,267,5,272,https://pilkada2015.kpu.go.id/surabayakota/krembangan/morokrembangan
TPS 31,542,260,40,213,253,7,260,https://pilkada2015.kpu.go.id/surabayakota/krembangan/morokrembangan
TPS 32,457,255,41,212,253,2,255,https://pilkada2015.kpu.go.id/surabayakota/krembangan/morokrembangan
TPS 33,521,282,44,230,274,8,282,https://pilkada2015.kpu.go.id/surabayakota/krembangan/morokrembangan
TPS 34,499,270,54,210,264,6,270,https://pilkada2015.kpu.go.id/surabayakota/krembangan/morokrembangan
TPS 35,570,268,53,211,264,4,268,https://pilkada2015.kpu.go.id/surabayakota/krembangan/morokrembangan
TPS 36,536,282,45,232,277,5,282,https://pilkada2015.kpu.go.id/surabayakota/krembangan/morokrembangan
TPS 37,472,243,34,207,241,2,243,https://pilkada2015.kpu.go.id/surabayakota/krembangan/morokrembangan
TPS 38,377,263,39,220,259,4,263,https://pilkada2015.kpu.go.id/surabayakota/krembangan/morokrembangan
TPS 39,533,235,37,195,232,3,235,https://pilkada2015.kpu.go.id/surabayakota/krembangan/morokrembangan
TPS 40,457,211,54,155,209,2,211,https://pilkada2015.kpu.go.id/surabayakota/krembangan/morokrembangan
TPS 41,676,308,37,269,306,2,308,https://pilkada2015.kpu.go.id/surabayakota/krembangan/morokrembangan
TPS 42,599,347,86,255,341,6,347,https://pilkada2015.kpu.go.id/surabayakota/krembangan/morokrembangan
TPS 43,633,342,72,262,337,5,342,https://pilkada2015.kpu.go.id/surabayakota/krembangan/morokrembangan
TPS 44,518,242,54,181,235,7,242,https://pilkada2015.kpu.go.id/surabayakota/krembangan/morokrembangan
TPS 45,698,385,52,326,378,7,385,https://pilkada2015.kpu.go.id/surabayakota/krembangan/morokrembangan
TPS 46,611,275,61,212,273,2,275,https://pilkada2015.kpu.go.id/surabayakota/krembangan/morokrembangan
TPS 47,581,312,50,260,310,2,312,https://pilkada2015.kpu.go.id/surabayakota/krembangan/morokrembangan
TPS 48,499,290,56,224,280,10,290,https://pilkada2015.kpu.go.id/surabayakota/krembangan/morokrembangan
TPS 49,541,229,63,159,222,7,229,https://pilkada2015.kpu.go.id/surabayakota/krembangan/morokrembangan
TPS 50,510,238,55,177,232,6,238,https://pilkada2015.kpu.go.id/surabayakota/krembangan/morokrembangan
TPS 51,540,250,47,200,247,3,250,https://pilkada2015.kpu.go.id/surabayakota/krembangan/morokrembangan
TPS 52,552,214,53,156,209,5,214,https://pilkada2015.kpu.go.id/surabayakota/krembangan/morokrembangan
TPS 53,552,199,60,130,190,9,199,https://pilkada2015.kpu.go.id/surabayakota/krembangan/morokrembangan
TPS 54,638,288,115,171,286,2,288,https://pilkada2015.kpu.go.id/surabayakota/krembangan/morokrembangan
TPS 55,639,301,65,231,296,5,301,https://pilkada2015.kpu.go.id/surabayakota/krembangan/morokrembangan
TPS 56,432,255,27,222,249,6,255,https://pilkada2015.kpu.go.id/surabayakota/krembangan/morokrembangan
TPS 57,528,313,45,258,303,10,313,https://pilkada2015.kpu.go.id/surabayakota/krembangan/morokrembangan
TPS 58,528,302,31,263,294,8,302,https://pilkada2015.kpu.go.id/surabayakota/krembangan/morokrembangan
TPS 1,485,155,27,128,155,0,155,https://pilkada2015.kpu.go.id/surabayakota/krembangan/perak_barat
TPS 2,441,207,32,170,202,5,207,https://pilkada2015.kpu.go.id/surabayakota/krembangan/perak_barat
TPS 3,440,211,29,180,209,2,211,https://pilkada2015.kpu.go.id/surabayakota/krembangan/perak_barat
TPS 4,535,283,40,233,273,10,283,https://pilkada2015.kpu.go.id/surabayakota/krembangan/perak_barat
TPS 5,542,244,45,193,238,6,244,https://pilkada2015.kpu.go.id/surabayakota/krembangan/perak_barat
TPS 6,543,233,29,202,231,2,233,https://pilkada2015.kpu.go.id/surabayakota/krembangan/perak_barat
TPS 7,506,223,25,192,217,6,223,https://pilkada2015.kpu.go.id/surabayakota/krembangan/perak_barat
TPS 8,478,263,43,217,260,3,263,https://pilkada2015.kpu.go.id/surabayakota/krembangan/perak_barat
TPS 9,439,198,26,168,194,4,198,https://pilkada2015.kpu.go.id/surabayakota/krembangan/perak_barat
TPS 10,383,252,21,229,250,2,252,https://pilkada2015.kpu.go.id/surabayakota/krembangan/perak_barat
TPS 11,459,226,21,204,225,1,226,https://pilkada2015.kpu.go.id/surabayakota/krembangan/perak_barat
TPS 12,426,151,16,133,149,2,151,https://pilkada2015.kpu.go.id/surabayakota/krembangan/perak_barat
TPS 13,640,319,23,292,315,4,319,https://pilkada2015.kpu.go.id/surabayakota/krembangan/perak_barat
TPS 14,545,231,26,204,230,1,231,https://pilkada2015.kpu.go.id/surabayakota/krembangan/perak_barat
TPS 15,526,182,18,164,182,0,182,https://pilkada2015.kpu.go.id/surabayakota/krembangan/perak_barat
TPS 16,537,271,30,232,262,9,271,https://pilkada2015.kpu.go.id/surabayakota/krembangan/perak_barat
TPS 17,566,225,42,180,222,3,225,https://pilkada2015.kpu.go.id/surabayakota/krembangan/perak_barat
TPS 18,491,220,28,190,218,2,220,https://pilkada2015.kpu.go.id/surabayakota/krembangan/perak_barat
TPS 19,402,175,22,148,170,5,175,https://pilkada2015.kpu.go.id/surabayakota/krembangan/perak_barat
TPS 20,424,228,18,208,226,2,228,https://pilkada2015.kpu.go.id/surabayakota/krembangan/perak_barat
TPS 21,664,322,30,291,321,1,322,https://pilkada2015.kpu.go.id/surabayakota/krembangan/perak_barat
TPS 22,581,284,31,252,283,1,284,https://pilkada2015.kpu.go.id/surabayakota/krembangan/perak_barat
TPS 23,586,265,21,244,265,0,265,https://pilkada2015.kpu.go.id/surabayakota/krembangan/perak_barat
TPS 1,661,339,68,264,332,7,339,https://pilkada2015.kpu.go.id/surabayakota/lakarsantri/bangkingan
TPS 2,565,276,47,221,268,8,276,https://pilkada2015.kpu.go.id/surabayakota/lakarsantri/bangkingan
TPS 3,491,213,40,167,207,6,213,https://pilkada2015.kpu.go.id/surabayakota/lakarsantri/bangkingan
TPS 4,588,307,36,258,294,13,307,https://pilkada2015.kpu.go.id/surabayakota/lakarsantri/bangkingan
TPS 5,490,228,53,165,218,10,228,https://pilkada2015.kpu.go.id/surabayakota/lakarsantri/bangkingan
TPS 6,548,277,78,195,273,4,277,https://pilkada2015.kpu.go.id/surabayakota/lakarsantri/bangkingan
TPS 7,454,273,59,210,269,4,273,https://pilkada2015.kpu.go.id/surabayakota/lakarsantri/bangkingan
TPS 8,418,255,25,227,252,3,255,https://pilkada2015.kpu.go.id/surabayakota/lakarsantri/bangkingan
TPS 9,418,238,34,203,237,1,238,https://pilkada2015.kpu.go.id/surabayakota/lakarsantri/bangkingan
TPS 10,470,333,47,280,0,0,0,https://pilkada2015.kpu.go.id/surabayakota/lakarsantri/bangkingan
TPS 11,373,232,18,214,232,0,232,https://pilkada2015.kpu.go.id/surabayakota/lakarsantri/bangkingan
TPS 1,563,341,53,284,337,4,341,https://pilkada2015.kpu.go.id/surabayakota/lakarsantri/jeruk
TPS 2,524,309,34,262,296,13,309,https://pilkada2015.kpu.go.id/surabayakota/lakarsantri/jeruk
TPS 3,551,331,48,273,321,10,331,https://pilkada2015.kpu.go.id/surabayakota/lakarsantri/jeruk
TPS 4,518,314,35,270,305,9,314,https://pilkada2015.kpu.go.id/surabayakota/lakarsantri/jeruk
TPS 5,564,355,60,282,342,13,355,https://pilkada2015.kpu.go.id/surabayakota/lakarsantri/jeruk
TPS 6,535,338,31,298,329,9,338,https://pilkada2015.kpu.go.id/surabayakota/lakarsantri/jeruk
TPS 7,538,323,37,276,313,10,323,https://pilkada2015.kpu.go.id/surabayakota/lakarsantri/jeruk
TPS 8,638,352,38,309,347,5,352,https://pilkada2015.kpu.go.id/surabayakota/lakarsantri/jeruk
TPS 9,639,399,47,344,391,8,399,https://pilkada2015.kpu.go.id/surabayakota/lakarsantri/jeruk
TPS 10,557,204,7,197,204,0,204,https://pilkada2015.kpu.go.id/surabayakota/lakarsantri/jeruk
TPS 1,581,405,50,344,394,11,405,https://pilkada2015.kpu.go.id/surabayakota/lakarsantri/lakarsantri
TPS 2,580,370,42,317,359,11,370,https://pilkada2015.kpu.go.id/surabayakota/lakarsantri/lakarsantri
TPS 3,625,390,48,331,379,11,390,https://pilkada2015.kpu.go.id/surabayakota/lakarsantri/lakarsantri
TPS 4,472,323,57,261,318,5,323,https://pilkada2015.kpu.go.id/surabayakota/lakarsantri/lakarsantri
TPS 5,573,351,38,303,341,10,351,https://pilkada2015.kpu.go.id/surabayakota/lakarsantri/lakarsantri
TPS 6,551,280,61,210,271,9,280,https://pilkada2015.kpu.go.id/surabayakota/lakarsantri/lakarsantri
TPS 7,460,287,41,239,280,7,287,https://pilkada2015.kpu.go.id/surabayakota/lakarsantri/lakarsantri
TPS 8,453,272,36,227,263,9,272,https://pilkada2015.kpu.go.id/surabayakota/lakarsantri/lakarsantri
TPS 9,559,340,30,305,335,5,340,https://pilkada2015.kpu.go.id/surabayakota/lakarsantri/lakarsantri
TPS 10,480,249,34,211,245,4,249,https://pilkada2015.kpu.go.id/surabayakota/lakarsantri/lakarsantri
TPS 1,427,268,26,236,262,6,268,https://pilkada2015.kpu.go.id/surabayakota/lakarsantri/lidah_kulon
TPS 2,451,263,30,229,259,4,263,https://pilkada2015.kpu.go.id/surabayakota/lakarsantri/lidah_kulon
TPS 3,444,276,40,228,268,8,276,https://pilkada2015.kpu.go.id/surabayakota/lakarsantri/lidah_kulon
TPS 4,630,350,42,305,347,3,350,https://pilkada2015.kpu.go.id/surabayakota/lakarsantri/lidah_kulon
TPS 5,655,325,42,278,320,5,325,https://pilkada2015.kpu.go.id/surabayakota/lakarsantri/lidah_kulon
TPS 6,709,452,49,395,444,8,452,https://pilkada2015.kpu.go.id/surabayakota/lakarsantri/lidah_kulon
TPS 7,501,245,30,212,242,3,245,https://pilkada2015.kpu.go.id/surabayakota/lakarsantri/lidah_kulon
TPS 8,386,246,44,200,244,2,246,https://pilkada2015.kpu.go.id/surabayakota/lakarsantri/lidah_kulon
TPS 9,527,295,48,236,284,11,295,https://pilkada2015.kpu.go.id/surabayakota/lakarsantri/lidah_kulon
TPS 10,579,334,51,275,326,8,334,https://pilkada2015.kpu.go.id/surabayakota/lakarsantri/lidah_kulon
TPS 11,559,341,43,292,335,6,341,https://pilkada2015.kpu.go.id/surabayakota/lakarsantri/lidah_kulon
TPS 12,496,280,36,229,265,15,280,https://pilkada2015.kpu.go.id/surabayakota/lakarsantri/lidah_kulon
TPS 13,470,265,35,220,255,10,265,https://pilkada2015.kpu.go.id/surabayakota/lakarsantri/lidah_kulon
TPS 14,587,300,26,272,298,2,300,https://pilkada2015.kpu.go.id/surabayakota/lakarsantri/lidah_kulon
TPS 15,545,276,33,239,272,4,276,https://pilkada2015.kpu.go.id/surabayakota/lakarsantri/lidah_kulon
TPS 16,524,286,33,250,283,3,286,https://pilkada2015.kpu.go.id/surabayakota/lakarsantri/lidah_kulon
TPS 17,520,205,22,183,205,0,205,https://pilkada2015.kpu.go.id/surabayakota/lakarsantri/lidah_kulon
TPS 18,473,193,8,185,193,0,193,https://pilkada2015.kpu.go.id/surabayakota/lakarsantri/lidah_kulon
TPS 19,668,325,47,277,324,1,325,https://pilkada2015.kpu.go.id/surabayakota/lakarsantri/lidah_kulon
TPS 20,723,343,30,309,339,4,343,https://pilkada2015.kpu.go.id/surabayakota/lakarsantri/lidah_kulon
TPS 1,608,390,46,338,384,6,390,https://pilkada2015.kpu.go.id/surabayakota/lakarsantri/lidah_wetan
TPS 2,604,346,68,269,337,9,346,https://pilkada2015.kpu.go.id/surabayakota/lakarsantri/lidah_wetan
TPS 3,620,388,39,344,383,5,388,https://pilkada2015.kpu.go.id/surabayakota/lakarsantri/lidah_wetan
TPS 4,615,371,30,335,365,6,371,https://pilkada2015.kpu.go.id/surabayakota/lakarsantri/lidah_wetan
TPS 5,599,364,31,319,350,14,364,https://pilkada2015.kpu.go.id/surabayakota/lakarsantri/lidah_wetan
TPS 6,593,368,44,320,364,4,368,https://pilkada2015.kpu.go.id/surabayakota/lakarsantri/lidah_wetan
TPS 7,471,260,33,220,253,7,260,https://pilkada2015.kpu.go.id/surabayakota/lakarsantri/lidah_wetan
TPS 8,464,277,30,235,265,12,277,https://pilkada2015.kpu.go.id/surabayakota/lakarsantri/lidah_wetan
TPS 9,468,259,23,231,254,5,259,https://pilkada2015.kpu.go.id/surabayakota/lakarsantri/lidah_wetan
TPS 10,344,229,13,212,225,4,229,https://pilkada2015.kpu.go.id/surabayakota/lakarsantri/lidah_wetan
TPS 11,397,209,25,183,208,1,209,https://pilkada2015.kpu.go.id/surabayakota/lakarsantri/lidah_wetan
TPS 12,392,211,23,187,210,1,211,https://pilkada2015.kpu.go.id/surabayakota/lakarsantri/lidah_wetan
TPS 13,617,159,10,149,159,0,159,https://pilkada2015.kpu.go.id/surabayakota/lakarsantri/lidah_wetan
TPS 14,596,206,17,189,206,0,206,https://pilkada2015.kpu.go.id/surabayakota/lakarsantri/lidah_wetan
TPS 1,325,254,50,191,241,13,254,https://pilkada2015.kpu.go.id/surabayakota/lakarsantri/sumur_welut
TPS 2,593,385,113,246,359,26,385,https://pilkada2015.kpu.go.id/surabayakota/lakarsantri/sumur_welut
TPS 3,568,387,90,269,359,28,387,https://pilkada2015.kpu.go.id/surabayakota/lakarsantri/sumur_welut
TPS 4,577,299,67,222,289,10,299,https://pilkada2015.kpu.go.id/surabayakota/lakarsantri/sumur_welut
TPS 5,586,360,56,295,351,9,360,https://pilkada2015.kpu.go.id/surabayakota/lakarsantri/sumur_welut
TPS 6,585,353,62,278,340,13,353,https://pilkada2015.kpu.go.id/surabayakota/lakarsantri/sumur_welut
TPS 1,616,210,11,199,0,210,210,https://pilkada2015.kpu.go.id/surabayakota/mulyorejo/dukuh_sutorejo
TPS 2,452,181,6,175,181,0,181,https://pilkada2015.kpu.go.id/surabayakota/mulyorejo/dukuh_sutorejo
TPS 3,449,253,34,216,250,3,253,https://pilkada2015.kpu.go.id/surabayakota/mulyorejo/dukuh_sutorejo
TPS 4,791,280,11,268,279,1,280,https://pilkada2015.kpu.go.id/surabayakota/mulyorejo/dukuh_sutorejo
TPS 5,380,176,11,160,171,5,176,https://pilkada2015.kpu.go.id/surabayakota/mulyorejo/dukuh_sutorejo
TPS 6,256,256,48,206,254,2,256,https://pilkada2015.kpu.go.id/surabayakota/mulyorejo/dukuh_sutorejo
TPS 7,487,214,32,172,204,10,214,https://pilkada2015.kpu.go.id/surabayakota/mulyorejo/dukuh_sutorejo
TPS 8,700,335,70,258,328,7,335,https://pilkada2015.kpu.go.id/surabayakota/mulyorejo/dukuh_sutorejo
TPS 9,638,368,53,303,356,12,368,https://pilkada2015.kpu.go.id/surabayakota/mulyorejo/dukuh_sutorejo
TPS 10,573,275,39,228,267,8,275,https://pilkada2015.kpu.go.id/surabayakota/mulyorejo/dukuh_sutorejo
TPS 11,376,166,41,122,163,3,166,https://pilkada2015.kpu.go.id/surabayakota/mulyorejo/dukuh_sutorejo
TPS 12,633,305,51,250,301,4,305,https://pilkada2015.kpu.go.id/surabayakota/mulyorejo/dukuh_sutorejo
TPS 13,576,262,23,234,257,5,262,https://pilkada2015.kpu.go.id/surabayakota/mulyorejo/dukuh_sutorejo
TPS 14,397,188,25,159,184,4,188,https://pilkada2015.kpu.go.id/surabayakota/mulyorejo/dukuh_sutorejo
TPS 15,468,226,18,206,224,2,226,https://pilkada2015.kpu.go.id/surabayakota/mulyorejo/dukuh_sutorejo
TPS 16,512,216,18,196,214,1,215,https://pilkada2015.kpu.go.id/surabayakota/mulyorejo/dukuh_sutorejo
TPS 17,508,263,21,238,259,4,263,https://pilkada2015.kpu.go.id/surabayakota/mulyorejo/dukuh_sutorejo
TPS 18,369,237,14,223,237,0,237,https://pilkada2015.kpu.go.id/surabayakota/mulyorejo/dukuh_sutorejo
TPS 19,418,230,26,202,228,2,230,https://pilkada2015.kpu.go.id/surabayakota/mulyorejo/dukuh_sutorejo
TPS 20,321,125,17,107,124,1,125,https://pilkada2015.kpu.go.id/surabayakota/mulyorejo/dukuh_sutorejo
TPS 21,596,213,10,203,213,0,213,https://pilkada2015.kpu.go.id/surabayakota/mulyorejo/dukuh_sutorejo
TPS 22,613,216,8,208,216,0,216,https://pilkada2015.kpu.go.id/surabayakota/mulyorejo/dukuh_sutorejo
TPS 23,605,212,15,196,211,1,212,https://pilkada2015.kpu.go.id/surabayakota/mulyorejo/dukuh_sutorejo
TPS 1,643,229,12,215,227,2,229,https://pilkada2015.kpu.go.id/surabayakota/mulyorejo/kalijudan
TPS 2,644,207,9,198,207,0,207,https://pilkada2015.kpu.go.id/surabayakota/mulyorejo/kalijudan
TPS 3,570,314,35,270,305,9,314,https://pilkada2015.kpu.go.id/surabayakota/mulyorejo/kalijudan
TPS 4,569,324,32,289,321,3,324,https://pilkada2015.kpu.go.id/surabayakota/mulyorejo/kalijudan
TPS 5,562,293,48,238,286,7,293,https://pilkada2015.kpu.go.id/surabayakota/mulyorejo/kalijudan
TPS 6,550,326,40,279,319,7,326,https://pilkada2015.kpu.go.id/surabayakota/mulyorejo/kalijudan
TPS 7,554,351,41,304,345,6,351,https://pilkada2015.kpu.go.id/surabayakota/mulyorejo/kalijudan
TPS 8,551,326,23,299,322,4,326,https://pilkada2015.kpu.go.id/surabayakota/mulyorejo/kalijudan
TPS 9,564,284,18,262,280,4,284,https://pilkada2015.kpu.go.id/surabayakota/mulyorejo/kalijudan
TPS 10,506,270,57,206,263,7,270,https://pilkada2015.kpu.go.id/surabayakota/mulyorejo/kalijudan
TPS 11,495,332,25,297,322,10,332,https://pilkada2015.kpu.go.id/surabayakota/mulyorejo/kalijudan
TPS 12,306,306,39,261,300,6,306,https://pilkada2015.kpu.go.id/surabayakota/mulyorejo/kalijudan
TPS 13,479,309,38,267,305,4,309,https://pilkada2015.kpu.go.id/surabayakota/mulyorejo/kalijudan
TPS 14,485,345,35,308,343,2,345,https://pilkada2015.kpu.go.id/surabayakota/mulyorejo/kalijudan
TPS 15,462,303,21,270,291,12,303,https://pilkada2015.kpu.go.id/surabayakota/mulyorejo/kalijudan
TPS 16,443,250,19,225,244,6,250,https://pilkada2015.kpu.go.id/surabayakota/mulyorejo/kalijudan
TPS 17,451,267,19,242,261,0,267,https://pilkada2015.kpu.go.id/surabayakota/mulyorejo/kalijudan
TPS 18,428,194,9,184,193,1,194,https://pilkada2015.kpu.go.id/surabayakota/mulyorejo/kalijudan
TPS 1,549,221,35,184,219,2,221,https://pilkada2015.kpu.go.id/surabayakota/mulyorejo/kalisari
TPS 2,542,248,15,228,243,5,248,https://pilkada2015.kpu.go.id/surabayakota/mulyorejo/kalisari
TPS 3,553,245,26,215,241,4,245,https://pilkada2015.kpu.go.id/surabayakota/mulyorejo/kalisari
TPS 4,578,258,23,233,256,2,258,https://pilkada2015.kpu.go.id/surabayakota/mulyorejo/kalisari
TPS 5,572,283,86,195,281,2,283,https://pilkada2015.kpu.go.id/surabayakota/mulyorejo/kalisari
TPS 6,560,560,95,194,289,6,295,https://pilkada2015.kpu.go.id/surabayakota/mulyorejo/kalisari
TPS 7,575,243,62,180,242,1,243,https://pilkada2015.kpu.go.id/surabayakota/mulyorejo/kalisari
TPS 8,563,207,25,178,203,4,207,https://pilkada2015.kpu.go.id/surabayakota/mulyorejo/kalisari
TPS 9,802,377,108,263,371,6,377,https://pilkada2015.kpu.go.id/surabayakota/mulyorejo/kalisari
TPS 10,619,273,27,242,269,4,273,https://pilkada2015.kpu.go.id/surabayakota/mulyorejo/kalisari
TPS 11,570,214,10,203,213,1,214,https://pilkada2015.kpu.go.id/surabayakota/mulyorejo/kalisari
TPS 12,524,198,23,166,189,9,198,https://pilkada2015.kpu.go.id/surabayakota/mulyorejo/kalisari
TPS 13,533,218,35,179,214,4,218,https://pilkada2015.kpu.go.id/surabayakota/mulyorejo/kalisari
TPS 14,571,221,26,195,221,0,221,https://pilkada2015.kpu.go.id/surabayakota/mulyorejo/kalisari
TPS 15,617,283,35,241,276,7,283,https://pilkada2015.kpu.go.id/surabayakota/mulyorejo/kalisari
TPS 16,511,183,11,171,182,1,183,https://pilkada2015.kpu.go.id/surabayakota/mulyorejo/kalisari
TPS 17,492,134,5,129,134,0,134,https://pilkada2015.kpu.go.id/surabayakota/mulyorejo/kalisari
TPS 18,772,251,18,231,249,2,251,https://pilkada2015.kpu.go.id/surabayakota/mulyorejo/kalisari
TPS 19,802,228,10,217,227,1,228,https://pilkada2015.kpu.go.id/surabayakota/mulyorejo/kalisari
TPS 1,578,270,43,223,266,4,270,https://pilkada2015.kpu.go.id/surabayakota/mulyorejo/kejawaan_putih_tamba
TPS 2,510,241,98,136,234,7,241,https://pilkada2015.kpu.go.id/surabayakota/mulyorejo/kejawaan_putih_tamba
TPS 3,519,209,51,155,206,3,209,https://pilkada2015.kpu.go.id/surabayakota/mulyorejo/kejawaan_putih_tamba
TPS 4,544,253,37,208,245,8,253,https://pilkada2015.kpu.go.id/surabayakota/mulyorejo/kejawaan_putih_tamba
TPS 5,442,235,40,187,227,8,235,https://pilkada2015.kpu.go.id/surabayakota/mulyorejo/kejawaan_putih_tamba
TPS 6,803,400,40,351,351,9,400,https://pilkada2015.kpu.go.id/surabayakota/mulyorejo/kejawaan_putih_tamba
TPS 7,653,171,7,164,171,0,171,https://pilkada2015.kpu.go.id/surabayakota/mulyorejo/kejawaan_putih_tamba
TPS 8,646,254,0,0,253,1,254,https://pilkada2015.kpu.go.id/surabayakota/mulyorejo/kejawaan_putih_tamba
TPS 1,628,269,42,224,266,3,269,https://pilkada2015.kpu.go.id/surabayakota/mulyorejo/manyar_sabrangan
TPS 2,695,300,55,241,296,4,300,https://pilkada2015.kpu.go.id/surabayakota/mulyorejo/manyar_sabrangan
TPS 3,511,297,50,244,294,3,297,https://pilkada2015.kpu.go.id/surabayakota/mulyorejo/manyar_sabrangan
TPS 4,530,260,41,214,255,5,260,https://pilkada2015.kpu.go.id/surabayakota/mulyorejo/manyar_sabrangan
TPS 5,570,306,39,257,296,10,306,https://pilkada2015.kpu.go.id/surabayakota/mulyorejo/manyar_sabrangan
TPS 6,648,298,40,256,296,2,298,https://pilkada2015.kpu.go.id/surabayakota/mulyorejo/manyar_sabrangan
TPS 7,631,247,48,195,243,4,247,https://pilkada2015.kpu.go.id/surabayakota/mulyorejo/manyar_sabrangan
TPS 8,647,254,42,208,250,4,254,https://pilkada2015.kpu.go.id/surabayakota/mulyorejo/manyar_sabrangan
TPS 9,698,245,34,207,241,4,245,https://pilkada2015.kpu.go.id/surabayakota/mulyorejo/manyar_sabrangan
TPS 10,591,269,56,211,267,2,269,https://pilkada2015.kpu.go.id/surabayakota/mulyorejo/manyar_sabrangan
TPS 11,593,294,36,252,288,6,294,https://pilkada2015.kpu.go.id/surabayakota/mulyorejo/manyar_sabrangan
TPS 12,579,285,43,237,280,5,285,https://pilkada2015.kpu.go.id/surabayakota/mulyorejo/manyar_sabrangan
TPS 13,479,247,29,212,241,6,247,https://pilkada2015.kpu.go.id/surabayakota/mulyorejo/manyar_sabrangan
TPS 14,517,198,24,173,197,1,198,https://pilkada2015.kpu.go.id/surabayakota/mulyorejo/manyar_sabrangan
TPS 15,474,156,11,145,156,0,156,https://pilkada2015.kpu.go.id/surabayakota/mulyorejo/manyar_sabrangan
TPS 16,221,221,11,209,220,1,221,https://pilkada2015.kpu.go.id/surabayakota/mulyorejo/manyar_sabrangan
TPS 17,316,155,5,150,155,0,155,https://pilkada2015.kpu.go.id/surabayakota/mulyorejo/manyar_sabrangan
TPS 18,519,211,18,190,208,3,211,https://pilkada2015.kpu.go.id/surabayakota/mulyorejo/manyar_sabrangan
TPS 19,702,213,17,195,212,1,213,https://pilkada2015.kpu.go.id/surabayakota/mulyorejo/manyar_sabrangan
TPS 20,585,173,9,162,171,2,173,https://pilkada2015.kpu.go.id/surabayakota/mulyorejo/manyar_sabrangan
TPS 21,677,208,16,189,205,3,208,https://pilkada2015.kpu.go.id/surabayakota/mulyorejo/manyar_sabrangan
TPS 22,567,148,14,131,145,3,148,https://pilkada2015.kpu.go.id/surabayakota/mulyorejo/manyar_sabrangan
TPS 23,604,201,20,180,200,1,201,https://pilkada2015.kpu.go.id/surabayakota/mulyorejo/manyar_sabrangan
TPS 24,511,252,27,222,249,3,252,https://pilkada2015.kpu.go.id/surabayakota/mulyorejo/manyar_sabrangan
TPS 1,790,369,44,318,362,7,369,https://pilkada2015.kpu.go.id/surabayakota/mulyorejo/mulyorejo
TPS 2,789,346,49,290,339,7,346,https://pilkada2015.kpu.go.id/surabayakota/mulyorejo/mulyorejo
TPS 3,748,411,62,333,395,16,411,https://pilkada2015.kpu.go.id/surabayakota/mulyorejo/mulyorejo
TPS 4,532,305,51,247,298,0,305,https://pilkada2015.kpu.go.id/surabayakota/mulyorejo/mulyorejo
TPS 5,716,324,56,259,315,9,324,https://pilkada2015.kpu.go.id/surabayakota/mulyorejo/mulyorejo
TPS 6,552,294,51,236,287,7,294,https://pilkada2015.kpu.go.id/surabayakota/mulyorejo/mulyorejo
TPS 7,731,346,49,294,343,3,346,https://pilkada2015.kpu.go.id/surabayakota/mulyorejo/mulyorejo
TPS 8,801,370,75,286,361,9,370,https://pilkada2015.kpu.go.id/surabayakota/mulyorejo/mulyorejo
TPS 9,497,288,63,219,282,6,288,https://pilkada2015.kpu.go.id/surabayakota/mulyorejo/mulyorejo
TPS 10,321,168,19,145,164,4,168,https://pilkada2015.kpu.go.id/surabayakota/mulyorejo/mulyorejo
TPS 11,602,259,39,220,259,0,259,https://pilkada2015.kpu.go.id/surabayakota/mulyorejo/mulyorejo
TPS 12,432,281,23,256,279,2,281,https://pilkada2015.kpu.go.id/surabayakota/mulyorejo/mulyorejo
TPS 13,506,265,16,248,264,1,265,https://pilkada2015.kpu.go.id/surabayakota/mulyorejo/mulyorejo
TPS 14,641,311,23,286,309,2,311,https://pilkada2015.kpu.go.id/surabayakota/mulyorejo/mulyorejo
TPS 15,491,177,18,159,177,0,177,https://pilkada2015.kpu.go.id/surabayakota/mulyorejo/mulyorejo
TPS 16,468,212,24,188,212,0,212,https://pilkada2015.kpu.go.id/surabayakota/mulyorejo/mulyorejo
TPS 17,606,213,15,197,212,1,213,https://pilkada2015.kpu.go.id/surabayakota/mulyorejo/mulyorejo
TPS 18,761,283,24,259,283,0,283,https://pilkada2015.kpu.go.id/surabayakota/mulyorejo/mulyorejo
TPS 19,707,232,9,223,232,0,232,https://pilkada2015.kpu.go.id/surabayakota/mulyorejo/mulyorejo
TPS 20,252,102,5,96,101,1,102,https://pilkada2015.kpu.go.id/surabayakota/mulyorejo/mulyorejo
TPS 21,272,117,6,110,116,1,117,https://pilkada2015.kpu.go.id/surabayakota/mulyorejo/mulyorejo
TPS 22,518,180,14,164,178,2,180,https://pilkada2015.kpu.go.id/surabayakota/mulyorejo/mulyorejo
TPS 1,397,194,41,151,192,2,194,https://pilkada2015.kpu.go.id/surabayakota/pabean_cantikan/bongkaran
TPS 2,471,172,27,141,168,4,172,https://pilkada2015.kpu.go.id/surabayakota/pabean_cantikan/bongkaran
TPS 3,361,137,51,83,134,3,137,https://pilkada2015.kpu.go.id/surabayakota/pabean_cantikan/bongkaran
TPS 4,321,101,18,81,99,2,101,https://pilkada2015.kpu.go.id/surabayakota/pabean_cantikan/bongkaran
TPS 5,498,201,19,179,198,3,201,https://pilkada2015.kpu.go.id/surabayakota/pabean_cantikan/bongkaran
TPS 6,477,194,21,170,191,3,194,https://pilkada2015.kpu.go.id/surabayakota/pabean_cantikan/bongkaran
TPS 7,691,338,48,278,326,12,338,https://pilkada2015.kpu.go.id/surabayakota/pabean_cantikan/bongkaran
TPS 8,584,276,42,229,271,5,276,https://pilkada2015.kpu.go.id/surabayakota/pabean_cantikan/bongkaran
TPS 9,694,288,42,241,283,5,288,https://pilkada2015.kpu.go.id/surabayakota/pabean_cantikan/bongkaran
TPS 10,418,217,55,157,212,5,217,https://pilkada2015.kpu.go.id/surabayakota/pabean_cantikan/bongkaran
TPS 11,446,194,39,147,186,8,194,https://pilkada2015.kpu.go.id/surabayakota/pabean_cantikan/bongkaran
TPS 12,518,221,26,191,217,4,221,https://pilkada2015.kpu.go.id/surabayakota/pabean_cantikan/bongkaran
TPS 13,476,240,33,198,231,9,240,https://pilkada2015.kpu.go.id/surabayakota/pabean_cantikan/bongkaran
TPS 14,593,244,57,181,238,6,244,https://pilkada2015.kpu.go.id/surabayakota/pabean_cantikan/bongkaran
TPS 15,548,295,44,246,290,5,295,https://pilkada2015.kpu.go.id/surabayakota/pabean_cantikan/bongkaran
TPS 16,261,132,7,124,131,1,132,https://pilkada2015.kpu.go.id/surabayakota/pabean_cantikan/bongkaran
TPS 17,223,92,8,83,91,1,92,https://pilkada2015.kpu.go.id/surabayakota/pabean_cantikan/bongkaran
TPS 1,512,266,44,214,258,8,266,https://pilkada2015.kpu.go.id/surabayakota/pabean_cantikan/krembangan_utara
TPS 2,497,252,60,187,247,5,252,https://pilkada2015.kpu.go.id/surabayakota/pabean_cantikan/krembangan_utara
TPS 3,493,232,33,195,228,4,232,https://pilkada2015.kpu.go.id/surabayakota/pabean_cantikan/krembangan_utara
TPS 4,446,180,26,151,177,3,180,https://pilkada2015.kpu.go.id/surabayakota/pabean_cantikan/krembangan_utara
TPS 5,553,297,37,258,295,2,297,https://pilkada2015.kpu.go.id/surabayakota/pabean_cantikan/krembangan_utara
TPS 6,580,356,62,292,354,2,356,https://pilkada2015.kpu.go.id/surabayakota/pabean_cantikan/krembangan_utara
TPS 7,525,207,26,178,204,3,207,https://pilkada2015.kpu.go.id/surabayakota/pabean_cantikan/krembangan_utara
TPS 8,443,229,12,211,223,6,229,https://pilkada2015.kpu.go.id/surabayakota/pabean_cantikan/krembangan_utara
TPS 9,421,191,22,166,188,3,191,https://pilkada2015.kpu.go.id/surabayakota/pabean_cantikan/krembangan_utara
TPS 10,457,205,19,180,199,6,205,https://pilkada2015.kpu.go.id/surabayakota/pabean_cantikan/krembangan_utara
TPS 11,609,288,25,259,284,4,288,https://pilkada2015.kpu.go.id/surabayakota/pabean_cantikan/krembangan_utara
TPS 12,564,217,25,187,212,5,217,https://pilkada2015.kpu.go.id/surabayakota/pabean_cantikan/krembangan_utara
TPS 13,496,204,29,169,198,6,204,https://pilkada2015.kpu.go.id/surabayakota/pabean_cantikan/krembangan_utara
TPS 14,417,211,41,163,204,7,211,https://pilkada2015.kpu.go.id/surabayakota/pabean_cantikan/krembangan_utara
TPS 15,408,205,28,173,201,4,205,https://pilkada2015.kpu.go.id/surabayakota/pabean_cantikan/krembangan_utara
TPS 16,369,101,22,77,99,2,101,https://pilkada2015.kpu.go.id/surabayakota/pabean_cantikan/krembangan_utara
TPS 17,367,196,19,174,193,3,196,https://pilkada2015.kpu.go.id/surabayakota/pabean_cantikan/krembangan_utara
TPS 18,400,198,14,180,194,4,198,https://pilkada2015.kpu.go.id/surabayakota/pabean_cantikan/krembangan_utara
TPS 19,460,239,27,209,236,3,239,https://pilkada2015.kpu.go.id/surabayakota/pabean_cantikan/krembangan_utara
TPS 20,459,200,35,163,198,2,200,https://pilkada2015.kpu.go.id/surabayakota/pabean_cantikan/krembangan_utara
TPS 21,441,115,26,89,115,0,115,https://pilkada2015.kpu.go.id/surabayakota/pabean_cantikan/krembangan_utara
TPS 22,559,273,33,229,262,11,273,https://pilkada2015.kpu.go.id/surabayakota/pabean_cantikan/krembangan_utara
TPS 23,558,219,46,164,210,9,219,https://pilkada2015.kpu.go.id/surabayakota/pabean_cantikan/krembangan_utara
TPS 24,636,243,29,207,236,7,243,https://pilkada2015.kpu.go.id/surabayakota/pabean_cantikan/krembangan_utara
TPS 25,545,217,30,181,211,6,217,https://pilkada2015.kpu.go.id/surabayakota/pabean_cantikan/krembangan_utara
TPS 1,584,192,53,134,187,5,192,https://pilkada2015.kpu.go.id/surabayakota/pabean_cantikan/nyamplungan
TPS 2,371,238,44,191,235,3,238,https://pilkada2015.kpu.go.id/surabayakota/pabean_cantikan/nyamplungan
TPS 3,416,198,36,159,195,3,198,https://pilkada2015.kpu.go.id/surabayakota/pabean_cantikan/nyamplungan
TPS 4,414,131,27,102,129,2,131,https://pilkada2015.kpu.go.id/surabayakota/pabean_cantikan/nyamplungan
TPS 5,285,141,28,107,135,6,141,https://pilkada2015.kpu.go.id/surabayakota/pabean_cantikan/nyamplungan
TPS 6,337,169,43,122,165,4,169,https://pilkada2015.kpu.go.id/surabayakota/pabean_cantikan/nyamplungan
TPS 7,512,184,11,170,181,3,184,https://pilkada2015.kpu.go.id/surabayakota/pabean_cantikan/nyamplungan
TPS 8,467,467,11,153,164,2,166,https://pilkada2015.kpu.go.id/surabayakota/pabean_cantikan/nyamplungan
TPS 9,478,209,35,171,206,3,209,https://pilkada2015.kpu.go.id/surabayakota/pabean_cantikan/nyamplungan
TPS 10,563,165,6,157,163,2,162,https://pilkada2015.kpu.go.id/surabayakota/pabean_cantikan/nyamplungan
TPS 11,724,208,52,147,199,9,208,https://pilkada2015.kpu.go.id/surabayakota/pabean_cantikan/nyamplungan
TPS 12,508,178,23,152,175,3,178,https://pilkada2015.kpu.go.id/surabayakota/pabean_cantikan/nyamplungan
TPS 13,684,190,38,149,187,3,190,https://pilkada2015.kpu.go.id/surabayakota/pabean_cantikan/nyamplungan
TPS 14,500,174,22,150,172,2,174,https://pilkada2015.kpu.go.id/surabayakota/pabean_cantikan/nyamplungan
TPS 15,471,155,11,141,152,3,155,https://pilkada2015.kpu.go.id/surabayakota/pabean_cantikan/nyamplungan
TPS 1,578,213,51,150,201,12,213,https://pilkada2015.kpu.go.id/surabayakota/pabean_cantikan/perak_timur
TPS 2,599,178,32,143,175,3,178,https://pilkada2015.kpu.go.id/surabayakota/pabean_cantikan/perak_timur
TPS 3,576,210,54,151,205,5,210,https://pilkada2015.kpu.go.id/surabayakota/pabean_cantikan/perak_timur
TPS 4,410,163,42,117,159,4,163,https://pilkada2015.kpu.go.id/surabayakota/pabean_cantikan/perak_timur
TPS 5,625,314,55,245,300,14,314,https://pilkada2015.kpu.go.id/surabayakota/pabean_cantikan/perak_timur
TPS 6,468,264,32,226,258,6,264,https://pilkada2015.kpu.go.id/surabayakota/pabean_cantikan/perak_timur
TPS 7,430,215,42,160,202,13,215,https://pilkada2015.kpu.go.id/surabayakota/pabean_cantikan/perak_timur
TPS 8,606,273,41,226,267,6,273,https://pilkada2015.kpu.go.id/surabayakota/pabean_cantikan/perak_timur
TPS 9,743,232,48,184,232,0,232,https://pilkada2015.kpu.go.id/surabayakota/pabean_cantikan/perak_timur
TPS 10,444,149,16,131,147,2,149,https://pilkada2015.kpu.go.id/surabayakota/pabean_cantikan/perak_timur
TPS 11,594,244,45,198,243,1,244,https://pilkada2015.kpu.go.id/surabayakota/pabean_cantikan/perak_timur
TPS 12,538,230,31,196,227,3,230,https://pilkada2015.kpu.go.id/surabayakota/pabean_cantikan/perak_timur
TPS 13,544,243,58,180,238,5,243,https://pilkada2015.kpu.go.id/surabayakota/pabean_cantikan/perak_timur
TPS 14,518,184,28,156,184,0,184,https://pilkada2015.kpu.go.id/surabayakota/pabean_cantikan/perak_timur
TPS 15,651,235,16,217,233,2,235,https://pilkada2015.kpu.go.id/surabayakota/pabean_cantikan/perak_timur
TPS 16,575,175,28,145,173,2,175,https://pilkada2015.kpu.go.id/surabayakota/pabean_cantikan/perak_timur
TPS 17,407,237,62,161,223,14,237,https://pilkada2015.kpu.go.id/surabayakota/pabean_cantikan/perak_timur
TPS 18,547,210,28,179,207,3,210,https://pilkada2015.kpu.go.id/surabayakota/pabean_cantikan/perak_timur
TPS 19,406,148,33,110,143,5,148,https://pilkada2015.kpu.go.id/surabayakota/pabean_cantikan/perak_timur
TPS 20,394,207,32,173,205,2,207,https://pilkada2015.kpu.go.id/surabayakota/pabean_cantikan/perak_timur
TPS 21,458,165,54,108,162,3,165,https://pilkada2015.kpu.go.id/surabayakota/pabean_cantikan/perak_timur
TPS 1,438,175,42,127,169,6,175,https://pilkada2015.kpu.go.id/surabayakota/pabean_cantikan/perak_utara
TPS 2,157,181,66,110,176,5,181,https://pilkada2015.kpu.go.id/surabayakota/pabean_cantikan/perak_utara
TPS 3,536,151,35,114,149,2,151,https://pilkada2015.kpu.go.id/surabayakota/pabean_cantikan/perak_utara
TPS 4,493,273,34,235,269,4,273,https://pilkada2015.kpu.go.id/surabayakota/pabean_cantikan/perak_utara
TPS 5,589,206,75,124,199,7,206,https://pilkada2015.kpu.go.id/surabayakota/pabean_cantikan/perak_utara
TPS 6,501,239,32,204,236,3,239,https://pilkada2015.kpu.go.id/surabayakota/pabean_cantikan/perak_utara
TPS 7,472,229,12,216,228,1,229,https://pilkada2015.kpu.go.id/surabayakota/pabean_cantikan/perak_utara
TPS 8,431,88,14,73,87,1,88,https://pilkada2015.kpu.go.id/surabayakota/pabean_cantikan/perak_utara
TPS 9,545,306,32,271,303,3,306,https://pilkada2015.kpu.go.id/surabayakota/pabean_cantikan/perak_utara
TPS 10,438,246,28,214,242,4,246,https://pilkada2015.kpu.go.id/surabayakota/pabean_cantikan/perak_utara
TPS 11,558,256,45,209,254,2,256,https://pilkada2015.kpu.go.id/surabayakota/pabean_cantikan/perak_utara
TPS 12,518,273,42,227,269,4,273,https://pilkada2015.kpu.go.id/surabayakota/pabean_cantikan/perak_utara
TPS 13,448,247,25,220,245,2,247,https://pilkada2015.kpu.go.id/surabayakota/pabean_cantikan/perak_utara
TPS 14,412,217,27,188,215,2,217,https://pilkada2015.kpu.go.id/surabayakota/pabean_cantikan/perak_utara
TPS 15,588,234,51,171,222,12,234,https://pilkada2015.kpu.go.id/surabayakota/pabean_cantikan/perak_utara
TPS 16,384,179,54,120,174,5,179,https://pilkada2015.kpu.go.id/surabayakota/pabean_cantikan/perak_utara
TPS 17,474,181,48,131,179,2,181,https://pilkada2015.kpu.go.id/surabayakota/pabean_cantikan/perak_utara
TPS 18,376,166,34,126,160,6,166,https://pilkada2015.kpu.go.id/surabayakota/pabean_cantikan/perak_utara
TPS 19,387,157,33,116,149,8,157,https://pilkada2015.kpu.go.id/surabayakota/pabean_cantikan/perak_utara
TPS 20,395,218,32,177,209,9,218,https://pilkada2015.kpu.go.id/surabayakota/pabean_cantikan/perak_utara
TPS 21,352,190,28,157,185,5,190,https://pilkada2015.kpu.go.id/surabayakota/pabean_cantikan/perak_utara
TPS 22,348,175,21,153,174,1,175,https://pilkada2015.kpu.go.id/surabayakota/pabean_cantikan/perak_utara
TPS 23,472,284,29,245,274,10,284,https://pilkada2015.kpu.go.id/surabayakota/pabean_cantikan/perak_utara
TPS 24,624,295,53,236,289,6,295,https://pilkada2015.kpu.go.id/surabayakota/pabean_cantikan/perak_utara
TPS 25,531,288,51,233,284,4,288,https://pilkada2015.kpu.go.id/surabayakota/pabean_cantikan/perak_utara
TPS 26,315,205,66,137,203,2,205,https://pilkada2015.kpu.go.id/surabayakota/pabean_cantikan/perak_utara
TPS 27,336,195,28,164,192,3,195,https://pilkada2015.kpu.go.id/surabayakota/pabean_cantikan/perak_utara
TPS 28,367,210,41,165,206,4,210,https://pilkada2015.kpu.go.id/surabayakota/pabean_cantikan/perak_utara
TPS 29,335,235,22,213,235,0,235,https://pilkada2015.kpu.go.id/surabayakota/pabean_cantikan/perak_utara
TPS 30,517,278,40,236,276,2,278,https://pilkada2015.kpu.go.id/surabayakota/pabean_cantikan/perak_utara
TPS 31,587,269,48,215,263,6,269,https://pilkada2015.kpu.go.id/surabayakota/pabean_cantikan/perak_utara
TPS 32,520,234,43,190,233,1,234,https://pilkada2015.kpu.go.id/surabayakota/pabean_cantikan/perak_utara
TPS 33,392,150,27,119,146,4,150,https://pilkada2015.kpu.go.id/surabayakota/pabean_cantikan/perak_utara
TPS 34,497,266,27,226,253,13,266,https://pilkada2015.kpu.go.id/surabayakota/pabean_cantikan/perak_utara
TPS 35,563,109,65,43,108,1,109,https://pilkada2015.kpu.go.id/surabayakota/pabean_cantikan/perak_utara
TPS 36,530,209,32,175,207,2,209,https://pilkada2015.kpu.go.id/surabayakota/pabean_cantikan/perak_utara
TPS 37,279,120,37,78,115,5,120,https://pilkada2015.kpu.go.id/surabayakota/pabean_cantikan/perak_utara
TPS 38,123,123,29,92,121,2,123,https://pilkada2015.kpu.go.id/surabayakota/pabean_cantikan/perak_utara
TPS 39,331,159,22,134,156,3,159,https://pilkada2015.kpu.go.id/surabayakota/pabean_cantikan/perak_utara
TPS 40,346,161,38,118,156,5,161,https://pilkada2015.kpu.go.id/surabayakota/pabean_cantikan/perak_utara
TPS 1,468,328,29,295,324,4,328,https://pilkada2015.kpu.go.id/surabayakota/pakal/babat_jerawat
TPS 2,369,234,28,198,226,8,234,https://pilkada2015.kpu.go.id/surabayakota/pakal/babat_jerawat
TPS 3,481,294,32,259,291,3,294,https://pilkada2015.kpu.go.id/surabayakota/pakal/babat_jerawat
TPS 4,598,338,36,300,336,2,338,https://pilkada2015.kpu.go.id/surabayakota/pakal/babat_jerawat
TPS 5,671,390,50,335,385,5,390,https://pilkada2015.kpu.go.id/surabayakota/pakal/babat_jerawat
TPS 6,389,231,55,173,228,3,231,https://pilkada2015.kpu.go.id/surabayakota/pakal/babat_jerawat
TPS 7,354,241,16,220,236,5,241,https://pilkada2015.kpu.go.id/surabayakota/pakal/babat_jerawat
TPS 8,413,250,38,210,248,2,250,https://pilkada2015.kpu.go.id/surabayakota/pakal/babat_jerawat
TPS 9,526,280,31,247,278,2,280,https://pilkada2015.kpu.go.id/surabayakota/pakal/babat_jerawat
TPS 10,588,304,24,277,301,3,304,https://pilkada2015.kpu.go.id/surabayakota/pakal/babat_jerawat
TPS 11,529,297,41,249,290,7,297,https://pilkada2015.kpu.go.id/surabayakota/pakal/babat_jerawat
TPS 12,682,380,43,333,376,4,380,https://pilkada2015.kpu.go.id/surabayakota/pakal/babat_jerawat
TPS 13,536,338,32,302,334,4,338,https://pilkada2015.kpu.go.id/surabayakota/pakal/babat_jerawat
TPS 14,707,382,37,343,380,2,382,https://pilkada2015.kpu.go.id/surabayakota/pakal/babat_jerawat
TPS 15,642,344,37,306,343,1,344,https://pilkada2015.kpu.go.id/surabayakota/pakal/babat_jerawat
TPS 16,598,293,33,254,287,6,293,https://pilkada2015.kpu.go.id/surabayakota/pakal/babat_jerawat
TPS 17,617,423,58,362,420,3,423,https://pilkada2015.kpu.go.id/surabayakota/pakal/babat_jerawat
TPS 18,546,363,39,321,360,3,363,https://pilkada2015.kpu.go.id/surabayakota/pakal/babat_jerawat
TPS 19,530,316,47,265,312,4,316,https://pilkada2015.kpu.go.id/surabayakota/pakal/babat_jerawat
TPS 20,580,318,53,260,313,5,318,https://pilkada2015.kpu.go.id/surabayakota/pakal/babat_jerawat
TPS 21,584,394,31,358,389,5,394,https://pilkada2015.kpu.go.id/surabayakota/pakal/babat_jerawat
TPS 22,644,429,62,358,420,9,429,https://pilkada2015.kpu.go.id/surabayakota/pakal/babat_jerawat
TPS 23,674,440,81,354,435,5,440,https://pilkada2015.kpu.go.id/surabayakota/pakal/babat_jerawat
TPS 24,545,202,8,194,202,0,202,https://pilkada2015.kpu.go.id/surabayakota/pakal/babat_jerawat
TPS 25,368,175,8,167,175,0,175,https://pilkada2015.kpu.go.id/surabayakota/pakal/babat_jerawat
TPS 26,597,299,28,267,295,4,299,https://pilkada2015.kpu.go.id/surabayakota/pakal/babat_jerawat
TPS 27,570,313,29,272,301,12,313,https://pilkada2015.kpu.go.id/surabayakota/pakal/babat_jerawat
TPS 1,478,251,35,214,249,2,251,https://pilkada2015.kpu.go.id/surabayakota/pakal/benowo
TPS 2,454,292,48,244,292,0,292,https://pilkada2015.kpu.go.id/surabayakota/pakal/benowo
TPS 3,573,347,30,310,340,7,347,https://pilkada2015.kpu.go.id/surabayakota/pakal/benowo
TPS 4,558,318,36,272,308,10,318,https://pilkada2015.kpu.go.id/surabayakota/pakal/benowo
TPS 5,505,275,37,231,268,7,275,https://pilkada2015.kpu.go.id/surabayakota/pakal/benowo
TPS 6,666,392,49,332,381,11,392,https://pilkada2015.kpu.go.id/surabayakota/pakal/benowo
TPS 7,639,390,44,340,384,6,390,https://pilkada2015.kpu.go.id/surabayakota/pakal/benowo
TPS 8,706,338,35,298,333,5,338,https://pilkada2015.kpu.go.id/surabayakota/pakal/benowo
TPS 9,539,412,42,347,389,23,412,https://pilkada2015.kpu.go.id/surabayakota/pakal/benowo
TPS 10,223,124,6,116,122,2,124,https://pilkada2015.kpu.go.id/surabayakota/pakal/benowo
TPS 11,439,286,13,268,281,5,286,https://pilkada2015.kpu.go.id/surabayakota/pakal/benowo
TPS 12,417,268,24,237,261,7,268,https://pilkada2015.kpu.go.id/surabayakota/pakal/benowo
TPS 1,431,251,47,198,245,6,251,https://pilkada2015.kpu.go.id/surabayakota/pakal/pakal
TPS 2,531,325,48,367,315,10,325,https://pilkada2015.kpu.go.id/surabayakota/pakal/pakal
TPS 3,418,345,56,274,330,15,345,https://pilkada2015.kpu.go.id/surabayakota/pakal/pakal
TPS 4,545,371,52,311,363,8,371,https://pilkada2015.kpu.go.id/surabayakota/pakal/pakal
TPS 5,494,356,40,309,349,7,356,https://pilkada2015.kpu.go.id/surabayakota/pakal/pakal
TPS 6,563,369,49,306,355,14,369,https://pilkada2015.kpu.go.id/surabayakota/pakal/pakal
TPS 7,537,359,58,293,351,8,359,https://pilkada2015.kpu.go.id/surabayakota/pakal/pakal
TPS 8,0,444,95,345,440,4,444,https://pilkada2015.kpu.go.id/surabayakota/pakal/pakal
TPS 9,603,394,37,352,389,5,394,https://pilkada2015.kpu.go.id/surabayakota/pakal/pakal
TPS 10,646,442,39,396,435,7,442,https://pilkada2015.kpu.go.id/surabayakota/pakal/pakal
TPS 1,507,362,46,307,353,9,362,https://pilkada2015.kpu.go.id/surabayakota/pakal/sumberrejo
TPS 2,539,376,48,319,367,9,376,https://pilkada2015.kpu.go.id/surabayakota/pakal/sumberrejo
TPS 3,579,359,20,327,347,12,359,https://pilkada2015.kpu.go.id/surabayakota/pakal/sumberrejo
TPS 4,685,441,35,398,433,8,441,https://pilkada2015.kpu.go.id/surabayakota/pakal/sumberrejo
TPS 5,569,408,23,376,399,9,408,https://pilkada2015.kpu.go.id/surabayakota/pakal/sumberrejo
TPS 6,456,360,22,329,351,9,360,https://pilkada2015.kpu.go.id/surabayakota/pakal/sumberrejo
TPS 7,281,236,13,219,232,4,236,https://pilkada2015.kpu.go.id/surabayakota/pakal/sumberrejo
TPS 8,681,481,72,403,475,6,481,https://pilkada2015.kpu.go.id/surabayakota/pakal/sumberrejo
TPS 9,789,514,50,463,513,1,514,https://pilkada2015.kpu.go.id/surabayakota/pakal/sumberrejo
TPS 10,544,299,31,266,297,2,299,https://pilkada2015.kpu.go.id/surabayakota/pakal/sumberrejo
TPS 11,459,397,19,371,390,7,397,https://pilkada2015.kpu.go.id/surabayakota/pakal/sumberrejo
TPS 12,584,386,27,358,385,1,386,https://pilkada2015.kpu.go.id/surabayakota/pakal/sumberrejo
TPS 13,446,329,35,287,322,7,329,https://pilkada2015.kpu.go.id/surabayakota/pakal/sumberrejo
TPS 1,454,272,39,231,270,2,272,https://pilkada2015.kpu.go.id/surabayakota/rungkut/kalirungkut
TPS 2,532,249,20,224,244,5,249,https://pilkada2015.kpu.go.id/surabayakota/rungkut/kalirungkut
TPS 3,541,319,37,276,313,6,319,https://pilkada2015.kpu.go.id/surabayakota/rungkut/kalirungkut
TPS 4,455,268,29,236,265,3,268,https://pilkada2015.kpu.go.id/surabayakota/rungkut/kalirungkut
TPS 5,541,323,26,291,317,6,323,https://pilkada2015.kpu.go.id/surabayakota/rungkut/kalirungkut
TPS 6,375,232,25,206,231,1,232,https://pilkada2015.kpu.go.id/surabayakota/rungkut/kalirungkut
TPS 7,363,185,20,161,181,4,185,https://pilkada2015.kpu.go.id/surabayakota/rungkut/kalirungkut
TPS 8,311,212,18,190,208,4,212,https://pilkada2015.kpu.go.id/surabayakota/rungkut/kalirungkut
TPS 9,310,196,15,180,195,1,196,https://pilkada2015.kpu.go.id/surabayakota/rungkut/kalirungkut
TPS 10,539,278,40,231,271,7,278,https://pilkada2015.kpu.go.id/surabayakota/rungkut/kalirungkut
TPS 11,430,260,41,213,254,6,260,https://pilkada2015.kpu.go.id/surabayakota/rungkut/kalirungkut
TPS 12,515,256,24,225,249,7,256,https://pilkada2015.kpu.go.id/surabayakota/rungkut/kalirungkut
TPS 13,529,354,41,306,347,7,354,https://pilkada2015.kpu.go.id/surabayakota/rungkut/kalirungkut
TPS 14,340,237,37,198,235,2,237,https://pilkada2015.kpu.go.id/surabayakota/rungkut/kalirungkut
TPS 15,554,344,24,318,342,2,344,https://pilkada2015.kpu.go.id/surabayakota/rungkut/kalirungkut
TPS 16,597,387,38,346,384,3,387,https://pilkada2015.kpu.go.id/surabayakota/rungkut/kalirungkut
TPS 17,504,291,51,231,282,9,291,https://pilkada2015.kpu.go.id/surabayakota/rungkut/kalirungkut
TPS 18,523,319,58,258,316,3,319,https://pilkada2015.kpu.go.id/surabayakota/rungkut/kalirungkut
TPS 19,394,284,34,243,277,7,284,https://pilkada2015.kpu.go.id/surabayakota/rungkut/kalirungkut
TPS 20,523,267,28,235,263,4,267,https://pilkada2015.kpu.go.id/surabayakota/rungkut/kalirungkut
TPS 21,526,315,24,285,309,6,315,https://pilkada2015.kpu.go.id/surabayakota/rungkut/kalirungkut
TPS 22,458,272,31,239,270,2,272,https://pilkada2015.kpu.go.id/surabayakota/rungkut/kalirungkut
TPS 23,497,267,36,229,265,2,267,https://pilkada2015.kpu.go.id/surabayakota/rungkut/kalirungkut
TPS 24,512,336,38,288,326,10,336,https://pilkada2015.kpu.go.id/surabayakota/rungkut/kalirungkut
TPS 25,714,452,63,383,446,6,452,https://pilkada2015.kpu.go.id/surabayakota/rungkut/kalirungkut
TPS 26,505,259,22,234,256,3,259,https://pilkada2015.kpu.go.id/surabayakota/rungkut/kalirungkut
TPS 27,491,364,26,337,363,1,364,https://pilkada2015.kpu.go.id/surabayakota/rungkut/kalirungkut
TPS 28,562,320,21,292,313,7,320,https://pilkada2015.kpu.go.id/surabayakota/rungkut/kalirungkut
TPS 29,432,296,20,271,291,5,296,https://pilkada2015.kpu.go.id/surabayakota/rungkut/kalirungkut
TPS 30,627,627,45,307,352,6,358,https://pilkada2015.kpu.go.id/surabayakota/rungkut/kalirungkut
TPS 31,621,331,51,275,326,5,331,https://pilkada2015.kpu.go.id/surabayakota/rungkut/kalirungkut
TPS 1,373,224,25,194,219,5,224,https://pilkada2015.kpu.go.id/surabayakota/rungkut/kedung_baruk
TPS 2,392,276,25,247,272,4,276,https://pilkada2015.kpu.go.id/surabayakota/rungkut/kedung_baruk
TPS 3,390,272,37,231,268,4,272,https://pilkada2015.kpu.go.id/surabayakota/rungkut/kedung_baruk
TPS 4,488,292,29,258,287,5,292,https://pilkada2015.kpu.go.id/surabayakota/rungkut/kedung_baruk
TPS 5,561,380,50,327,377,3,380,https://pilkada2015.kpu.go.id/surabayakota/rungkut/kedung_baruk
TPS 6,315,219,29,188,217,2,219,https://pilkada2015.kpu.go.id/surabayakota/rungkut/kedung_baruk
TPS 7,0,0,0,0,0,0,0,https://pilkada2015.kpu.go.id/surabayakota/rungkut/kedung_baruk
TPS 8,487,350,72,277,349,1,350,https://pilkada2015.kpu.go.id/surabayakota/rungkut/kedung_baruk
TPS 9,717,420,32,386,418,2,420,https://pilkada2015.kpu.go.id/surabayakota/rungkut/kedung_baruk
TPS 10,653,371,26,340,366,5,371,https://pilkada2015.kpu.go.id/surabayakota/rungkut/kedung_baruk
TPS 11,485,305,27,274,301,4,305,https://pilkada2015.kpu.go.id/surabayakota/rungkut/kedung_baruk
TPS 12,353,230,37,189,226,4,230,https://pilkada2015.kpu.go.id/surabayakota/rungkut/kedung_baruk
TPS 13,448,276,43,228,271,5,276,https://pilkada2015.kpu.go.id/surabayakota/rungkut/kedung_baruk
TPS 14,727,428,94,331,425,3,428,https://pilkada2015.kpu.go.id/surabayakota/rungkut/kedung_baruk
TPS 15,311,224,47,169,216,8,224,https://pilkada2015.kpu.go.id/surabayakota/rungkut/kedung_baruk
TPS 16,597,368,40,324,364,4,368,https://pilkada2015.kpu.go.id/surabayakota/rungkut/kedung_baruk
TPS 17,623,451,45,402,447,4,451,https://pilkada2015.kpu.go.id/surabayakota/rungkut/kedung_baruk
TPS 18,589,280,16,258,274,6,280,https://pilkada2015.kpu.go.id/surabayakota/rungkut/kedung_baruk
TPS 19,617,277,17,256,273,4,277,https://pilkada2015.kpu.go.id/surabayakota/rungkut/kedung_baruk
TPS 20,523,226,15,211,226,0,226,https://pilkada2015.kpu.go.id/surabayakota/rungkut/kedung_baruk
TPS 21,754,425,28,392,420,5,425,https://pilkada2015.kpu.go.id/surabayakota/rungkut/kedung_baruk
TPS 22,300,180,25,153,178,2,180,https://pilkada2015.kpu.go.id/surabayakota/rungkut/kedung_baruk
TPS 1,535,311,29,280,309,2,311,https://pilkada2015.kpu.go.id/surabayakota/rungkut/medokan_ayu
TPS 2,508,265,37,226,263,2,265,https://pilkada2015.kpu.go.id/surabayakota/rungkut/medokan_ayu
TPS 3,320,320,26,287,313,7,320,https://pilkada2015.kpu.go.id/surabayakota/rungkut/medokan_ayu
TPS 4,480,219,28,189,217,2,219,https://pilkada2015.kpu.go.id/surabayakota/rungkut/medokan_ayu
TPS 5,542,332,37,293,330,2,332,https://pilkada2015.kpu.go.id/surabayakota/rungkut/medokan_ayu
TPS 6,572,341,41,298,339,2,341,https://pilkada2015.kpu.go.id/surabayakota/rungkut/medokan_ayu
TPS 7,634,399,38,359,397,2,399,https://pilkada2015.kpu.go.id/surabayakota/rungkut/medokan_ayu
TPS 8,439,288,26,259,285,3,288,https://pilkada2015.kpu.go.id/surabayakota/rungkut/medokan_ayu
TPS 9,520,316,41,273,314,2,316,https://pilkada2015.kpu.go.id/surabayakota/rungkut/medokan_ayu
TPS 10,498,301,28,269,297,4,301,https://pilkada2015.kpu.go.id/surabayakota/rungkut/medokan_ayu
TPS 11,510,314,31,279,310,4,314,https://pilkada2015.kpu.go.id/surabayakota/rungkut/medokan_ayu
TPS 12,648,377,35,337,372,5,377,https://pilkada2015.kpu.go.id/surabayakota/rungkut/medokan_ayu
TPS 13,608,425,34,389,423,2,425,https://pilkada2015.kpu.go.id/surabayakota/rungkut/medokan_ayu
TPS 14,425,201,29,171,200,1,201,https://pilkada2015.kpu.go.id/surabayakota/rungkut/medokan_ayu
TPS 15,578,366,39,319,358,8,366,https://pilkada2015.kpu.go.id/surabayakota/rungkut/medokan_ayu
TPS 16,293,183,19,160,179,4,183,https://pilkada2015.kpu.go.id/surabayakota/rungkut/medokan_ayu
TPS 17,433,249,22,224,246,3,249,https://pilkada2015.kpu.go.id/surabayakota/rungkut/medokan_ayu
TPS 18,536,321,33,286,319,2,321,https://pilkada2015.kpu.go.id/surabayakota/rungkut/medokan_ayu
TPS 19,470,279,19,258,277,2,279,https://pilkada2015.kpu.go.id/surabayakota/rungkut/medokan_ayu
TPS 20,324,171,22,148,170,1,171,https://pilkada2015.kpu.go.id/surabayakota/rungkut/medokan_ayu
TPS 21,548,361,50,307,357,4,361,https://pilkada2015.kpu.go.id/surabayakota/rungkut/medokan_ayu
TPS 22,552,377,78,297,375,2,377,https://pilkada2015.kpu.go.id/surabayakota/rungkut/medokan_ayu
TPS 23,515,356,41,312,353,3,356,https://pilkada2015.kpu.go.id/surabayakota/rungkut/medokan_ayu
TPS 24,447,272,14,256,270,2,272,https://pilkada2015.kpu.go.id/surabayakota/rungkut/medokan_ayu
TPS 25,669,420,30,387,417,3,420,https://pilkada2015.kpu.go.id/surabayakota/rungkut/medokan_ayu
TPS 26,503,314,24,285,309,5,314,https://pilkada2015.kpu.go.id/surabayakota/rungkut/medokan_ayu
TPS 27,426,275,33,236,269,6,275,https://pilkada2015.kpu.go.id/surabayakota/rungkut/medokan_ayu
TPS 28,494,333,39,289,328,5,333,https://pilkada2015.kpu.go.id/surabayakota/rungkut/medokan_ayu
TPS 1,507,323,28,294,322,1,323,https://pilkada2015.kpu.go.id/surabayakota/rungkut/penjaringan_sari
TPS 2,508,309,29,277,306,3,309,https://pilkada2015.kpu.go.id/surabayakota/rungkut/penjaringan_sari
TPS 3,520,323,25,291,316,7,323,https://pilkada2015.kpu.go.id/surabayakota/rungkut/penjaringan_sari
TPS 4,568,314,27,284,311,3,314,https://pilkada2015.kpu.go.id/surabayakota/rungkut/penjaringan_sari
TPS 5,515,334,56,274,330,4,334,https://pilkada2015.kpu.go.id/surabayakota/rungkut/penjaringan_sari
TPS 6,562,310,34,273,307,3,310,https://pilkada2015.kpu.go.id/surabayakota/rungkut/penjaringan_sari
TPS 7,497,224,19,204,223,1,224,https://pilkada2015.kpu.go.id/surabayakota/rungkut/penjaringan_sari
TPS 8,511,310,31,277,308,2,310,https://pilkada2015.kpu.go.id/surabayakota/rungkut/penjaringan_sari
TPS 9,475,331,30,293,323,8,331,https://pilkada2015.kpu.go.id/surabayakota/rungkut/penjaringan_sari
TPS 10,500,258,10,246,256,2,258,https://pilkada2015.kpu.go.id/surabayakota/rungkut/penjaringan_sari
TPS 11,378,243,48,193,241,2,243,https://pilkada2015.kpu.go.id/surabayakota/rungkut/penjaringan_sari
TPS 12,368,232,32,198,230,2,232,https://pilkada2015.kpu.go.id/surabayakota/rungkut/penjaringan_sari
TPS 13,435,249,30,213,243,6,249,https://pilkada2015.kpu.go.id/surabayakota/rungkut/penjaringan_sari
TPS 14,409,278,24,252,276,2,278,https://pilkada2015.kpu.go.id/surabayakota/rungkut/penjaringan_sari
TPS 15,425,251,35,216,251,0,251,https://pilkada2015.kpu.go.id/surabayakota/rungkut/penjaringan_sari
TPS 16,373,231,22,208,230,1,231,https://pilkada2015.kpu.go.id/surabayakota/rungkut/penjaringan_sari
TPS 17,463,320,48,269,317,3,320,https://pilkada2015.kpu.go.id/surabayakota/rungkut/penjaringan_sari
TPS 18,402,268,43,222,265,3,268,https://pilkada2015.kpu.go.id/surabayakota/rungkut/penjaringan_sari
TPS 19,470,180,16,162,178,2,180,https://pilkada2015.kpu.go.id/surabayakota/rungkut/penjaringan_sari
TPS 20,555,316,68,245,313,3,316,https://pilkada2015.kpu.go.id/surabayakota/rungkut/penjaringan_sari
TPS 21,499,256,29,225,254,2,256,https://pilkada2015.kpu.go.id/surabayakota/rungkut/penjaringan_sari
TPS 22,598,356,51,300,351,5,356,https://pilkada2015.kpu.go.id/surabayakota/rungkut/penjaringan_sari
TPS 23,418,273,30,241,271,2,273,https://pilkada2015.kpu.go.id/surabayakota/rungkut/penjaringan_sari
TPS 24,422,273,46,223,269,4,273,https://pilkada2015.kpu.go.id/surabayakota/rungkut/penjaringan_sari
TPS 1,535,326,41,272,313,13,326,https://pilkada2015.kpu.go.id/surabayakota/rungkut/rungkut_kidul
TPS 2,609,366,36,321,357,9,366,https://pilkada2015.kpu.go.id/surabayakota/rungkut/rungkut_kidul
TPS 3,555,320,41,276,317,3,320,https://pilkada2015.kpu.go.id/surabayakota/rungkut/rungkut_kidul
TPS 4,625,351,55,294,349,2,351,https://pilkada2015.kpu.go.id/surabayakota/rungkut/rungkut_kidul
TPS 5,639,639,63,318,381,11,392,https://pilkada2015.kpu.go.id/surabayakota/rungkut/rungkut_kidul
TPS 6,452,283,45,236,281,2,283,https://pilkada2015.kpu.go.id/surabayakota/rungkut/rungkut_kidul
TPS 7,552,328,45,274,319,9,328,https://pilkada2015.kpu.go.id/surabayakota/rungkut/rungkut_kidul
TPS 8,545,364,53,306,359,5,364,https://pilkada2015.kpu.go.id/surabayakota/rungkut/rungkut_kidul
TPS 9,454,269,87,177,264,5,269,https://pilkada2015.kpu.go.id/surabayakota/rungkut/rungkut_kidul
TPS 10,517,308,45,259,304,4,308,https://pilkada2015.kpu.go.id/surabayakota/rungkut/rungkut_kidul
TPS 11,480,285,27,252,279,6,285,https://pilkada2015.kpu.go.id/surabayakota/rungkut/rungkut_kidul
TPS 12,509,295,27,267,294,1,295,https://pilkada2015.kpu.go.id/surabayakota/rungkut/rungkut_kidul
TPS 13,299,167,20,145,165,2,167,https://pilkada2015.kpu.go.id/surabayakota/rungkut/rungkut_kidul
TPS 14,362,215,28,185,213,2,215,https://pilkada2015.kpu.go.id/surabayakota/rungkut/rungkut_kidul
TPS 15,595,351,36,307,343,8,351,https://pilkada2015.kpu.go.id/surabayakota/rungkut/rungkut_kidul
TPS 16,622,357,48,306,354,3,357,https://pilkada2015.kpu.go.id/surabayakota/rungkut/rungkut_kidul
TPS 17,432,240,28,210,238,2,240,https://pilkada2015.kpu.go.id/surabayakota/rungkut/rungkut_kidul
TPS 18,500,350,0,0,346,4,350,https://pilkada2015.kpu.go.id/surabayakota/rungkut/rungkut_kidul
TPS 1,583,381,14,366,380,1,381,https://pilkada2015.kpu.go.id/surabayakota/rungkut/wonorejo
TPS 2,599,324,9,313,322,2,324,https://pilkada2015.kpu.go.id/surabayakota/rungkut/wonorejo
TPS 3,550,317,9,305,314,3,317,https://pilkada2015.kpu.go.id/surabayakota/rungkut/wonorejo
TPS 4,344,259,6,248,254,5,259,https://pilkada2015.kpu.go.id/surabayakota/rungkut/wonorejo
TPS 5,686,365,10,348,358,7,365,https://pilkada2015.kpu.go.id/surabayakota/rungkut/wonorejo
TPS 6,598,420,64,349,413,7,420,https://pilkada2015.kpu.go.id/surabayakota/rungkut/wonorejo
TPS 7,523,341,34,302,336,5,341,https://pilkada2015.kpu.go.id/surabayakota/rungkut/wonorejo
TPS 8,344,205,26,178,204,1,205,https://pilkada2015.kpu.go.id/surabayakota/rungkut/wonorejo
TPS 9,399,238,31,206,237,1,238,https://pilkada2015.kpu.go.id/surabayakota/rungkut/wonorejo
TPS 10,476,314,43,268,311,3,314,https://pilkada2015.kpu.go.id/surabayakota/rungkut/wonorejo
TPS 11,632,346,59,280,339,7,346,https://pilkada2015.kpu.go.id/surabayakota/rungkut/wonorejo
TPS 12,457,322,49,257,306,16,322,https://pilkada2015.kpu.go.id/surabayakota/rungkut/wonorejo
TPS 13,511,298,51,242,293,5,298,https://pilkada2015.kpu.go.id/surabayakota/rungkut/wonorejo
TPS 14,563,306,62,242,304,2,306,https://pilkada2015.kpu.go.id/surabayakota/rungkut/wonorejo
TPS 15,314,193,31,156,187,6,193,https://pilkada2015.kpu.go.id/surabayakota/rungkut/wonorejo
TPS 16,663,426,41,378,419,7,426,https://pilkada2015.kpu.go.id/surabayakota/rungkut/wonorejo
TPS 17,480,279,28,241,269,10,279,https://pilkada2015.kpu.go.id/surabayakota/rungkut/wonorejo
TPS 18,455,271,30,241,271,0,271,https://pilkada2015.kpu.go.id/surabayakota/rungkut/wonorejo
TPS 1,531,364,50,307,357,7,364,https://pilkada2015.kpu.go.id/surabayakota/sambikerep/bringin
TPS 2,561,346,54,284,338,8,346,https://pilkada2015.kpu.go.id/surabayakota/sambikerep/bringin
TPS 3,633,372,46,315,361,11,372,https://pilkada2015.kpu.go.id/surabayakota/sambikerep/bringin
TPS 4,494,283,52,227,279,4,283,https://pilkada2015.kpu.go.id/surabayakota/sambikerep/bringin
TPS 5,628,399,106,281,387,12,399,https://pilkada2015.kpu.go.id/surabayakota/sambikerep/bringin
TPS 6,598,290,37,246,283,7,290,https://pilkada2015.kpu.go.id/surabayakota/sambikerep/bringin
TPS 1,488,256,27,219,246,10,256,https://pilkada2015.kpu.go.id/surabayakota/sambikerep/lontar
TPS 2,407,199,32,165,197,2,199,https://pilkada2015.kpu.go.id/surabayakota/sambikerep/lontar
TPS 3,395,201,37,160,197,4,201,https://pilkada2015.kpu.go.id/surabayakota/sambikerep/lontar
TPS 4,562,263,43,218,261,2,263,https://pilkada2015.kpu.go.id/surabayakota/sambikerep/lontar
TPS 5,543,255,43,208,251,4,255,https://pilkada2015.kpu.go.id/surabayakota/sambikerep/lontar
TPS 6,534,274,50,212,262,12,274,https://pilkada2015.kpu.go.id/surabayakota/sambikerep/lontar
TPS 7,606,355,57,290,347,8,355,https://pilkada2015.kpu.go.id/surabayakota/sambikerep/lontar
TPS 8,604,427,57,365,422,5,427,https://pilkada2015.kpu.go.id/surabayakota/sambikerep/lontar
TPS 9,599,340,42,292,334,6,340,https://pilkada2015.kpu.go.id/surabayakota/sambikerep/lontar
TPS 10,611,308,30,270,300,8,308,https://pilkada2015.kpu.go.id/surabayakota/sambikerep/lontar
TPS 11,528,271,81,179,260,11,271,https://pilkada2015.kpu.go.id/surabayakota/sambikerep/lontar
TPS 12,542,318,83,228,311,7,318,https://pilkada2015.kpu.go.id/surabayakota/sambikerep/lontar
TPS 13,644,315,55,250,305,10,315,https://pilkada2015.kpu.go.id/surabayakota/sambikerep/lontar
TPS 14,573,258,45,210,255,3,258,https://pilkada2015.kpu.go.id/surabayakota/sambikerep/lontar
TPS 15,614,339,53,282,335,3,338,https://pilkada2015.kpu.go.id/surabayakota/sambikerep/lontar
TPS 16,557,350,47,300,347,3,350,https://pilkada2015.kpu.go.id/surabayakota/sambikerep/lontar
TPS 17,519,340,79,252,331,9,340,https://pilkada2015.kpu.go.id/surabayakota/sambikerep/lontar
TPS 18,580,332,64,262,326,6,332,https://pilkada2015.kpu.go.id/surabayakota/sambikerep/lontar
TPS 19,529,278,34,241,275,3,278,https://pilkada2015.kpu.go.id/surabayakota/sambikerep/lontar
TPS 20,461,273,31,236,267,6,273,https://pilkada2015.kpu.go.id/surabayakota/sambikerep/lontar
TPS 21,384,261,32,225,257,4,261,https://pilkada2015.kpu.go.id/surabayakota/sambikerep/lontar
TPS 22,612,377,49,321,370,7,377,https://pilkada2015.kpu.go.id/surabayakota/sambikerep/lontar
TPS 23,543,280,52,226,278,2,280,https://pilkada2015.kpu.go.id/surabayakota/sambikerep/lontar
TPS 24,508,234,24,209,233,1,234,https://pilkada2015.kpu.go.id/surabayakota/sambikerep/lontar
TPS 25,562,303,46,250,296,7,303,https://pilkada2015.kpu.go.id/surabayakota/sambikerep/lontar
TPS 26,501,324,45,274,319,5,324,https://pilkada2015.kpu.go.id/surabayakota/sambikerep/lontar
TPS 27,482,231,6,221,227,4,231,https://pilkada2015.kpu.go.id/surabayakota/sambikerep/lontar
TPS 28,471,245,17,226,243,2,245,https://pilkada2015.kpu.go.id/surabayakota/sambikerep/lontar
TPS 29,470,294,24,269,293,1,294,https://pilkada2015.kpu.go.id/surabayakota/sambikerep/lontar
TPS 30,470,199,7,189,196,3,199,https://pilkada2015.kpu.go.id/surabayakota/sambikerep/lontar
TPS 31,380,146,6,132,138,8,146,https://pilkada2015.kpu.go.id/surabayakota/sambikerep/lontar
TPS 32,503,292,28,259,287,5,292,https://pilkada2015.kpu.go.id/surabayakota/sambikerep/lontar
TPS 33,461,248,39,207,246,2,248,https://pilkada2015.kpu.go.id/surabayakota/sambikerep/lontar
TPS 34,451,241,35,204,239,2,241,https://pilkada2015.kpu.go.id/surabayakota/sambikerep/lontar
TPS 35,409,240,30,202,232,8,240,https://pilkada2015.kpu.go.id/surabayakota/sambikerep/lontar
TPS 36,688,262,8,253,261,1,262,https://pilkada2015.kpu.go.id/surabayakota/sambikerep/lontar
TPS 1,442,257,75,176,251,6,257,https://pilkada2015.kpu.go.id/surabayakota/sambikerep/made
TPS 2,501,285,38,241,279,6,285,https://pilkada2015.kpu.go.id/surabayakota/sambikerep/made
TPS 3,535,286,52,233,285,1,286,https://pilkada2015.kpu.go.id/surabayakota/sambikerep/made
TPS 4,670,433,57,372,429,4,433,https://pilkada2015.kpu.go.id/surabayakota/sambikerep/made
TPS 5,617,380,44,329,373,7,380,https://pilkada2015.kpu.go.id/surabayakota/sambikerep/made
TPS 6,654,362,47,310,357,5,362,https://pilkada2015.kpu.go.id/surabayakota/sambikerep/made
TPS 7,607,340,62,269,331,9,340,https://pilkada2015.kpu.go.id/surabayakota/sambikerep/made
TPS 8,485,261,63,185,248,13,261,https://pilkada2015.kpu.go.id/surabayakota/sambikerep/made
TPS 9,487,255,66,180,246,9,255,https://pilkada2015.kpu.go.id/surabayakota/sambikerep/made
TPS 10,677,329,11,318,329,0,329,https://pilkada2015.kpu.go.id/surabayakota/sambikerep/made
TPS 1,569,313,37,273,310,3,313,https://pilkada2015.kpu.go.id/surabayakota/sambikerep/sambikerep
TPS 2,517,293,36,253,289,4,293,https://pilkada2015.kpu.go.id/surabayakota/sambikerep/sambikerep
TPS 3,609,337,48,286,334,3,337,https://pilkada2015.kpu.go.id/surabayakota/sambikerep/sambikerep
TPS 4,351,219,49,163,212,7,219,https://pilkada2015.kpu.go.id/surabayakota/sambikerep/sambikerep
TPS 5,290,190,36,151,187,3,190,https://pilkada2015.kpu.go.id/surabayakota/sambikerep/sambikerep
TPS 6,476,291,22,264,286,5,291,https://pilkada2015.kpu.go.id/surabayakota/sambikerep/sambikerep
TPS 7,492,280,44,231,275,5,280,https://pilkada2015.kpu.go.id/surabayakota/sambikerep/sambikerep
TPS 8,544,309,49,257,306,3,309,https://pilkada2015.kpu.go.id/surabayakota/sambikerep/sambikerep
TPS 9,507,289,38,249,287,2,289,https://pilkada2015.kpu.go.id/surabayakota/sambikerep/sambikerep
TPS 10,477,274,28,243,271,3,274,https://pilkada2015.kpu.go.id/surabayakota/sambikerep/sambikerep
TPS 11,619,350,48,299,347,3,350,https://pilkada2015.kpu.go.id/surabayakota/sambikerep/sambikerep
TPS 12,773,451,63,380,443,8,451,https://pilkada2015.kpu.go.id/surabayakota/sambikerep/sambikerep
TPS 13,631,478,54,405,459,19,478,https://pilkada2015.kpu.go.id/surabayakota/sambikerep/sambikerep
TPS 14,525,171,40,124,164,7,171,https://pilkada2015.kpu.go.id/surabayakota/sambikerep/sambikerep
TPS 15,482,217,30,186,216,1,217,https://pilkada2015.kpu.go.id/surabayakota/sambikerep/sambikerep
TPS 16,441,182,25,151,176,6,182,https://pilkada2015.kpu.go.id/surabayakota/sambikerep/sambikerep
TPS 17,564,311,81,225,306,5,311,https://pilkada2015.kpu.go.id/surabayakota/sambikerep/sambikerep
TPS 18,571,356,157,190,347,9,356,https://pilkada2015.kpu.go.id/surabayakota/sambikerep/sambikerep
TPS 19,525,296,122,164,286,10,296,https://pilkada2015.kpu.go.id/surabayakota/sambikerep/sambikerep
TPS 20,503,285,121,161,282,3,285,https://pilkada2015.kpu.go.id/surabayakota/sambikerep/sambikerep
TPS 21,745,355,59,291,350,5,355,https://pilkada2015.kpu.go.id/surabayakota/sambikerep/sambikerep
TPS 22,547,228,9,217,226,2,228,https://pilkada2015.kpu.go.id/surabayakota/sambikerep/sambikerep
TPS 23,560,235,15,218,233,2,235,https://pilkada2015.kpu.go.id/surabayakota/sambikerep/sambikerep
TPS 24,416,163,6,157,163,0,163,https://pilkada2015.kpu.go.id/surabayakota/sambikerep/sambikerep
TPS 25,593,256,13,241,254,2,256,https://pilkada2015.kpu.go.id/surabayakota/sambikerep/sambikerep
TPS 1,571,346,30,312,342,4,346,https://pilkada2015.kpu.go.id/surabayakota/sawahan/banyu_urip
TPS 2,473,338,13,317,330,8,338,https://pilkada2015.kpu.go.id/surabayakota/sawahan/banyu_urip
TPS 3,466,0,16,313,329,3,332,https://pilkada2015.kpu.go.id/surabayakota/sawahan/banyu_urip
TPS 4,577,321,46,270,316,5,321,https://pilkada2015.kpu.go.id/surabayakota/sawahan/banyu_urip
TPS 5,431,267,27,234,261,6,267,https://pilkada2015.kpu.go.id/surabayakota/sawahan/banyu_urip
TPS 6,674,360,44,302,346,14,360,https://pilkada2015.kpu.go.id/surabayakota/sawahan/banyu_urip
TPS 7,508,290,24,260,284,6,290,https://pilkada2015.kpu.go.id/surabayakota/sawahan/banyu_urip
TPS 8,437,229,27,201,228,1,229,https://pilkada2015.kpu.go.id/surabayakota/sawahan/banyu_urip
TPS 9,456,245,49,191,240,5,245,https://pilkada2015.kpu.go.id/surabayakota/sawahan/banyu_urip
TPS 10,513,253,0,0,249,4,253,https://pilkada2015.kpu.go.id/surabayakota/sawahan/banyu_urip
TPS 11,495,268,23,242,265,3,268,https://pilkada2015.kpu.go.id/surabayakota/sawahan/banyu_urip
TPS 12,548,268,40,226,266,2,268,https://pilkada2015.kpu.go.id/surabayakota/sawahan/banyu_urip
TPS 13,569,285,30,253,283,2,285,https://pilkada2015.kpu.go.id/surabayakota/sawahan/banyu_urip
TPS 14,523,305,31,267,298,7,305,https://pilkada2015.kpu.go.id/surabayakota/sawahan/banyu_urip
TPS 15,549,311,38,272,310,1,311,https://pilkada2015.kpu.go.id/surabayakota/sawahan/banyu_urip
TPS 16,505,260,36,216,252,8,260,https://pilkada2015.kpu.go.id/surabayakota/sawahan/banyu_urip
TPS 17,467,257,52,200,252,5,257,https://pilkada2015.kpu.go.id/surabayakota/sawahan/banyu_urip
TPS 18,532,286,55,225,280,6,286,https://pilkada2015.kpu.go.id/surabayakota/sawahan/banyu_urip
TPS 19,536,224,33,183,216,8,224,https://pilkada2015.kpu.go.id/surabayakota/sawahan/banyu_urip
TPS 20,517,212,46,158,204,8,212,https://pilkada2015.kpu.go.id/surabayakota/sawahan/banyu_urip
TPS 21,513,276,42,227,269,7,276,https://pilkada2015.kpu.go.id/surabayakota/sawahan/banyu_urip
TPS 22,518,300,33,261,294,6,300,https://pilkada2015.kpu.go.id/surabayakota/sawahan/banyu_urip
TPS 23,254,254,34,217,251,3,254,https://pilkada2015.kpu.go.id/surabayakota/sawahan/banyu_urip
TPS 24,518,268,51,211,262,6,268,https://pilkada2015.kpu.go.id/surabayakota/sawahan/banyu_urip
TPS 25,262,262,41,213,254,8,262,https://pilkada2015.kpu.go.id/surabayakota/sawahan/banyu_urip
TPS 26,374,231,45,180,225,6,231,https://pilkada2015.kpu.go.id/surabayakota/sawahan/banyu_urip
TPS 27,349,175,43,128,171,4,175,https://pilkada2015.kpu.go.id/surabayakota/sawahan/banyu_urip
TPS 28,486,258,4,210,254,4,258,https://pilkada2015.kpu.go.id/surabayakota/sawahan/banyu_urip
TPS 29,467,238,44,189,233,5,238,https://pilkada2015.kpu.go.id/surabayakota/sawahan/banyu_urip
TPS 30,396,227,38,182,220,7,227,https://pilkada2015.kpu.go.id/surabayakota/sawahan/banyu_urip
TPS 31,489,271,35,225,260,11,271,https://pilkada2015.kpu.go.id/surabayakota/sawahan/banyu_urip
TPS 32,521,344,42,294,336,8,344,https://pilkada2015.kpu.go.id/surabayakota/sawahan/banyu_urip
TPS 33,589,318,34,279,313,0,318,https://pilkada2015.kpu.go.id/surabayakota/sawahan/banyu_urip
TPS 34,491,257,32,223,255,2,257,https://pilkada2015.kpu.go.id/surabayakota/sawahan/banyu_urip
TPS 35,586,228,37,184,221,7,228,https://pilkada2015.kpu.go.id/surabayakota/sawahan/banyu_urip
TPS 36,522,287,32,248,280,7,287,https://pilkada2015.kpu.go.id/surabayakota/sawahan/banyu_urip
TPS 37,545,258,45,209,254,4,258,https://pilkada2015.kpu.go.id/surabayakota/sawahan/banyu_urip
TPS 38,528,249,36,209,245,4,249,https://pilkada2015.kpu.go.id/surabayakota/sawahan/banyu_urip
TPS 39,533,330,64,259,323,7,330,https://pilkada2015.kpu.go.id/surabayakota/sawahan/banyu_urip
TPS 40,509,326,39,285,324,2,326,https://pilkada2015.kpu.go.id/surabayakota/sawahan/banyu_urip
TPS 41,591,289,48,237,285,4,289,https://pilkada2015.kpu.go.id/surabayakota/sawahan/banyu_urip
TPS 42,553,287,40,246,286,1,287,https://pilkada2015.kpu.go.id/surabayakota/sawahan/banyu_urip
TPS 43,551,309,56,243,299,10,309,https://pilkada2015.kpu.go.id/surabayakota/sawahan/banyu_urip
TPS 44,519,234,49,179,228,6,234,https://pilkada2015.kpu.go.id/surabayakota/sawahan/banyu_urip
TPS 45,574,279,47,224,271,8,279,https://pilkada2015.kpu.go.id/surabayakota/sawahan/banyu_urip
TPS 46,527,267,41,220,261,6,267,https://pilkada2015.kpu.go.id/surabayakota/sawahan/banyu_urip
TPS 47,624,360,60,293,353,7,360,https://pilkada2015.kpu.go.id/surabayakota/sawahan/banyu_urip
TPS 48,584,299,36,252,288,11,299,https://pilkada2015.kpu.go.id/surabayakota/sawahan/banyu_urip
TPS 49,394,213,49,157,207,6,213,https://pilkada2015.kpu.go.id/surabayakota/sawahan/banyu_urip
TPS 50,483,265,44,219,263,2,265,https://pilkada2015.kpu.go.id/surabayakota/sawahan/banyu_urip
TPS 51,483,251,39,206,245,6,251,https://pilkada2015.kpu.go.id/surabayakota/sawahan/banyu_urip
TPS 52,519,260,49,201,250,10,260,https://pilkada2015.kpu.go.id/surabayakota/sawahan/banyu_urip
TPS 53,520,317,37,274,311,6,317,https://pilkada2015.kpu.go.id/surabayakota/sawahan/banyu_urip
TPS 54,589,289,40,243,283,6,289,https://pilkada2015.kpu.go.id/surabayakota/sawahan/banyu_urip
TPS 55,541,307,42,260,302,5,307,https://pilkada2015.kpu.go.id/surabayakota/sawahan/banyu_urip
TPS 1,576,300,39,256,295,5,300,https://pilkada2015.kpu.go.id/surabayakota/sawahan/kupang_krajan
TPS 2,507,278,18,252,270,8,278,https://pilkada2015.kpu.go.id/surabayakota/sawahan/kupang_krajan
TPS 3,477,285,63,214,277,8,285,https://pilkada2015.kpu.go.id/surabayakota/sawahan/kupang_krajan
TPS 4,454,247,26,220,246,1,247,https://pilkada2015.kpu.go.id/surabayakota/sawahan/kupang_krajan
TPS 5,637,334,46,283,329,5,334,https://pilkada2015.kpu.go.id/surabayakota/sawahan/kupang_krajan
TPS 6,568,305,37,262,299,6,305,https://pilkada2015.kpu.go.id/surabayakota/sawahan/kupang_krajan
TPS 7,478,258,34,224,258,0,258,https://pilkada2015.kpu.go.id/surabayakota/sawahan/kupang_krajan
TPS 8,412,169,19,146,165,4,169,https://pilkada2015.kpu.go.id/surabayakota/sawahan/kupang_krajan
TPS 9,485,288,42,244,286,2,288,https://pilkada2015.kpu.go.id/surabayakota/sawahan/kupang_krajan
TPS 10,559,296,45,248,293,3,296,https://pilkada2015.kpu.go.id/surabayakota/sawahan/kupang_krajan
TPS 11,376,206,35,169,204,2,206,https://pilkada2015.kpu.go.id/surabayakota/sawahan/kupang_krajan
TPS 12,517,270,37,231,268,2,270,https://pilkada2015.kpu.go.id/surabayakota/sawahan/kupang_krajan
TPS 13,471,262,44,209,253,9,262,https://pilkada2015.kpu.go.id/surabayakota/sawahan/kupang_krajan
TPS 14,496,278,29,246,275,3,278,https://pilkada2015.kpu.go.id/surabayakota/sawahan/kupang_krajan
TPS 15,466,248,30,214,224,4,248,https://pilkada2015.kpu.go.id/surabayakota/sawahan/kupang_krajan
TPS 16,515,275,26,233,259,16,275,https://pilkada2015.kpu.go.id/surabayakota/sawahan/kupang_krajan
TPS 17,652,290,55,231,286,4,290,https://pilkada2015.kpu.go.id/surabayakota/sawahan/kupang_krajan
TPS 18,733,324,64,256,320,4,324,https://pilkada2015.kpu.go.id/surabayakota/sawahan/kupang_krajan
TPS 19,532,262,34,225,259,3,262,https://pilkada2015.kpu.go.id/surabayakota/sawahan/kupang_krajan
TPS 20,566,280,45,227,272,8,280,https://pilkada2015.kpu.go.id/surabayakota/sawahan/kupang_krajan
TPS 21,639,330,31,292,323,7,330,https://pilkada2015.kpu.go.id/surabayakota/sawahan/kupang_krajan
TPS 22,719,326,64,252,316,10,326,https://pilkada2015.kpu.go.id/surabayakota/sawahan/kupang_krajan
TPS 23,429,227,11,213,224,3,227,https://pilkada2015.kpu.go.id/surabayakota/sawahan/kupang_krajan
TPS 24,521,292,17,268,285,7,292,https://pilkada2015.kpu.go.id/surabayakota/sawahan/kupang_krajan
TPS 25,502,252,30,213,243,9,252,https://pilkada2015.kpu.go.id/surabayakota/sawahan/kupang_krajan
TPS 26,517,288,34,240,274,14,288,https://pilkada2015.kpu.go.id/surabayakota/sawahan/kupang_krajan
TPS 27,534,284,34,241,275,9,284,https://pilkada2015.kpu.go.id/surabayakota/sawahan/kupang_krajan
TPS 28,482,293,65,220,285,8,293,https://pilkada2015.kpu.go.id/surabayakota/sawahan/kupang_krajan
TPS 29,429,289,64,213,277,12,289,https://pilkada2015.kpu.go.id/surabayakota/sawahan/kupang_krajan
TPS 30,483,253,21,228,249,4,253,https://pilkada2015.kpu.go.id/surabayakota/sawahan/kupang_krajan
TPS 31,434,249,43,200,243,6,249,https://pilkada2015.kpu.go.id/surabayakota/sawahan/kupang_krajan
TPS 32,516,266,29,232,261,5,266,https://pilkada2015.kpu.go.id/surabayakota/sawahan/kupang_krajan
TPS 33,458,290,36,250,286,4,290,https://pilkada2015.kpu.go.id/surabayakota/sawahan/kupang_krajan
TPS 34,570,345,36,303,339,6,345,https://pilkada2015.kpu.go.id/surabayakota/sawahan/kupang_krajan
TPS 1,580,328,43,279,322,6,328,https://pilkada2015.kpu.go.id/surabayakota/sawahan/pakis
TPS 2,462,243,18,222,240,3,243,https://pilkada2015.kpu.go.id/surabayakota/sawahan/pakis
TPS 3,707,381,43,333,376,5,381,https://pilkada2015.kpu.go.id/surabayakota/sawahan/pakis
TPS 4,625,327,46,272,318,9,327,https://pilkada2015.kpu.go.id/surabayakota/sawahan/pakis
TPS 5,564,281,37,238,275,6,281,https://pilkada2015.kpu.go.id/surabayakota/sawahan/pakis
TPS 6,469,296,57,227,284,12,296,https://pilkada2015.kpu.go.id/surabayakota/sawahan/pakis
TPS 7,517,267,31,228,259,8,267,https://pilkada2015.kpu.go.id/surabayakota/sawahan/pakis
TPS 8,525,317,59,250,309,8,317,https://pilkada2015.kpu.go.id/surabayakota/sawahan/pakis
TPS 9,399,231,32,196,228,3,231,https://pilkada2015.kpu.go.id/surabayakota/sawahan/pakis
TPS 10,630,321,47,269,316,5,321,https://pilkada2015.kpu.go.id/surabayakota/sawahan/pakis
TPS 11,478,282,42,232,274,8,282,https://pilkada2015.kpu.go.id/surabayakota/sawahan/pakis
TPS 12,630,320,41,274,315,5,320,https://pilkada2015.kpu.go.id/surabayakota/sawahan/pakis
TPS 13,576,302,44,253,297,5,302,https://pilkada2015.kpu.go.id/surabayakota/sawahan/pakis
TPS 14,644,417,47,363,410,7,417,https://pilkada2015.kpu.go.id/surabayakota/sawahan/pakis
TPS 15,467,283,36,244,280,3,283,https://pilkada2015.kpu.go.id/surabayakota/sawahan/pakis
TPS 16,638,382,40,331,371,11,382,https://pilkada2015.kpu.go.id/surabayakota/sawahan/pakis
TPS 17,656,402,55,335,390,12,402,https://pilkada2015.kpu.go.id/surabayakota/sawahan/pakis
TPS 18,444,245,36,205,241,4,245,https://pilkada2015.kpu.go.id/surabayakota/sawahan/pakis
TPS 19,311,201,24,174,198,3,201,https://pilkada2015.kpu.go.id/surabayakota/sawahan/pakis
TPS 20,615,389,44,337,381,8,389,https://pilkada2015.kpu.go.id/surabayakota/sawahan/pakis
TPS 21,661,334,65,266,331,3,334,https://pilkada2015.kpu.go.id/surabayakota/sawahan/pakis
TPS 22,601,265,26,234,260,5,265,https://pilkada2015.kpu.go.id/surabayakota/sawahan/pakis
TPS 23,325,229,35,191,226,3,229,https://pilkada2015.kpu.go.id/surabayakota/sawahan/pakis
TPS 24,503,285,30,254,284,1,285,https://pilkada2015.kpu.go.id/surabayakota/sawahan/pakis
TPS 25,360,198,37,159,196,2,198,https://pilkada2015.kpu.go.id/surabayakota/sawahan/pakis
TPS 26,293,293,34,256,290,0,293,https://pilkada2015.kpu.go.id/surabayakota/sawahan/pakis
TPS 27,652,348,52,292,344,4,348,https://pilkada2015.kpu.go.id/surabayakota/sawahan/pakis
TPS 28,699,313,58,251,309,4,313,https://pilkada2015.kpu.go.id/surabayakota/sawahan/pakis
TPS 29,487,255,60,191,251,4,255,https://pilkada2015.kpu.go.id/surabayakota/sawahan/pakis
TPS 30,568,259,49,209,258,1,259,https://pilkada2015.kpu.go.id/surabayakota/sawahan/pakis
TPS 31,462,250,26,220,246,4,250,https://pilkada2015.kpu.go.id/surabayakota/sawahan/pakis
TPS 32,434,247,37,205,242,5,247,https://pilkada2015.kpu.go.id/surabayakota/sawahan/pakis
TPS 33,510,260,23,227,250,10,260,https://pilkada2015.kpu.go.id/surabayakota/sawahan/pakis
TPS 34,591,300,45,250,295,5,300,https://pilkada2015.kpu.go.id/surabayakota/sawahan/pakis
TPS 35,507,310,28,272,300,10,310,https://pilkada2015.kpu.go.id/surabayakota/sawahan/pakis
TPS 36,587,336,20,310,0,0,0,https://pilkada2015.kpu.go.id/surabayakota/sawahan/pakis
TPS 37,480,315,34,274,308,7,315,https://pilkada2015.kpu.go.id/surabayakota/sawahan/pakis
TPS 38,471,243,32,206,238,5,243,https://pilkada2015.kpu.go.id/surabayakota/sawahan/pakis
TPS 39,413,241,34,200,234,7,241,https://pilkada2015.kpu.go.id/surabayakota/sawahan/pakis
TPS 40,609,266,87,174,261,5,266,https://pilkada2015.kpu.go.id/surabayakota/sawahan/pakis
TPS 41,601,361,87,266,353,8,361,https://pilkada2015.kpu.go.id/surabayakota/sawahan/pakis
TPS 42,529,266,31,231,262,4,266,https://pilkada2015.kpu.go.id/surabayakota/sawahan/pakis
TPS 43,575,323,50,257,307,3,310,https://pilkada2015.kpu.go.id/surabayakota/sawahan/pakis
TPS 44,664,351,61,280,341,10,351,https://pilkada2015.kpu.go.id/surabayakota/sawahan/pakis
TPS 45,539,277,53,213,266,11,277,https://pilkada2015.kpu.go.id/surabayakota/sawahan/pakis
TPS 46,566,285,46,235,281,4,285,https://pilkada2015.kpu.go.id/surabayakota/sawahan/pakis
TPS 47,483,293,50,237,287,6,293,https://pilkada2015.kpu.go.id/surabayakota/sawahan/pakis
TPS 48,558,307,88,210,298,9,307,https://pilkada2015.kpu.go.id/surabayakota/sawahan/pakis
TPS 49,534,209,29,175,204,5,209,https://pilkada2015.kpu.go.id/surabayakota/sawahan/pakis
TPS 50,501,223,12,208,220,3,223,https://pilkada2015.kpu.go.id/surabayakota/sawahan/pakis
TPS 1,549,261,24,232,256,5,261,https://pilkada2015.kpu.go.id/surabayakota/sawahan/petemon
TPS 2,580,352,38,307,347,7,352,https://pilkada2015.kpu.go.id/surabayakota/sawahan/petemon
TPS 3,388,210,36,169,205,5,210,https://pilkada2015.kpu.go.id/surabayakota/sawahan/petemon
TPS 4,498,244,18,222,240,4,244,https://pilkada2015.kpu.go.id/surabayakota/sawahan/petemon
TPS 5,262,148,14,132,146,2,148,https://pilkada2015.kpu.go.id/surabayakota/sawahan/petemon
TPS 6,434,259,16,236,252,7,259,https://pilkada2015.kpu.go.id/surabayakota/sawahan/petemon
TPS 7,303,156,15,138,153,3,156,https://pilkada2015.kpu.go.id/surabayakota/sawahan/petemon
TPS 8,568,212,13,198,211,1,212,https://pilkada2015.kpu.go.id/surabayakota/sawahan/petemon
TPS 9,493,236,33,200,233,3,236,https://pilkada2015.kpu.go.id/surabayakota/sawahan/petemon
TPS 10,492,255,21,228,249,6,255,https://pilkada2015.kpu.go.id/surabayakota/sawahan/petemon
TPS 11,644,325,33,284,317,8,325,https://pilkada2015.kpu.go.id/surabayakota/sawahan/petemon
TPS 12,717,352,55,293,348,4,352,https://pilkada2015.kpu.go.id/surabayakota/sawahan/petemon
TPS 13,636,260,40,218,258,2,260,https://pilkada2015.kpu.go.id/surabayakota/sawahan/petemon
TPS 14,741,252,22,223,245,7,252,https://pilkada2015.kpu.go.id/surabayakota/sawahan/petemon
TPS 15,740,330,23,304,327,3,330,https://pilkada2015.kpu.go.id/surabayakota/sawahan/petemon
TPS 16,510,262,36,224,260,2,262,https://pilkada2015.kpu.go.id/surabayakota/sawahan/petemon
TPS 17,566,298,31,255,286,12,298,https://pilkada2015.kpu.go.id/surabayakota/sawahan/petemon
TPS 18,615,329,37,285,322,7,329,https://pilkada2015.kpu.go.id/surabayakota/sawahan/petemon
TPS 19,577,311,34,277,311,0,311,https://pilkada2015.kpu.go.id/surabayakota/sawahan/petemon
TPS 20,683,373,44,324,368,5,373,https://pilkada2015.kpu.go.id/surabayakota/sawahan/petemon
TPS 21,665,296,20,273,293,3,296,https://pilkada2015.kpu.go.id/surabayakota/sawahan/petemon
TPS 22,405,207,34,169,203,4,207,https://pilkada2015.kpu.go.id/surabayakota/sawahan/petemon
TPS 23,413,211,13,195,208,3,211,https://pilkada2015.kpu.go.id/surabayakota/sawahan/petemon
TPS 24,401,401,50,347,397,4,401,https://pilkada2015.kpu.go.id/surabayakota/sawahan/petemon
TPS 25,791,375,50,322,372,3,375,https://pilkada2015.kpu.go.id/surabayakota/sawahan/petemon
TPS 26,765,403,44,355,399,4,403,https://pilkada2015.kpu.go.id/surabayakota/sawahan/petemon
TPS 27,405,196,17,177,194,2,196,https://pilkada2015.kpu.go.id/surabayakota/sawahan/petemon
TPS 28,435,225,21,201,222,3,225,https://pilkada2015.kpu.go.id/surabayakota/sawahan/petemon
TPS 29,403,244,24,216,240,4,244,https://pilkada2015.kpu.go.id/surabayakota/sawahan/petemon
TPS 30,604,364,52,307,359,5,364,https://pilkada2015.kpu.go.id/surabayakota/sawahan/petemon
TPS 31,787,396,43,344,387,7,394,https://pilkada2015.kpu.go.id/surabayakota/sawahan/petemon
TPS 32,395,221,14,204,218,3,221,https://pilkada2015.kpu.go.id/surabayakota/sawahan/petemon
TPS 33,688,309,28,276,304,5,309,https://pilkada2015.kpu.go.id/surabayakota/sawahan/petemon
TPS 34,628,306,51,252,303,3,306,https://pilkada2015.kpu.go.id/surabayakota/sawahan/petemon
TPS 35,601,337,41,290,331,6,337,https://pilkada2015.kpu.go.id/surabayakota/sawahan/petemon
TPS 36,479,215,29,182,0,0,0,https://pilkada2015.kpu.go.id/surabayakota/sawahan/petemon
TPS 37,392,226,40,184,224,2,226,https://pilkada2015.kpu.go.id/surabayakota/sawahan/petemon
TPS 38,595,294,35,252,287,7,294,https://pilkada2015.kpu.go.id/surabayakota/sawahan/petemon
TPS 39,419,231,15,210,225,6,231,https://pilkada2015.kpu.go.id/surabayakota/sawahan/petemon
TPS 40,688,368,40,319,359,9,368,https://pilkada2015.kpu.go.id/surabayakota/sawahan/petemon
TPS 41,517,302,37,256,293,9,302,https://pilkada2015.kpu.go.id/surabayakota/sawahan/petemon
TPS 42,423,228,33,194,227,1,228,https://pilkada2015.kpu.go.id/surabayakota/sawahan/petemon
TPS 43,443,224,24,198,222,2,224,https://pilkada2015.kpu.go.id/surabayakota/sawahan/petemon
TPS 44,485,265,25,238,263,2,265,https://pilkada2015.kpu.go.id/surabayakota/sawahan/petemon
TPS 45,454,213,20,191,211,2,213,https://pilkada2015.kpu.go.id/surabayakota/sawahan/petemon
TPS 46,506,284,25,251,276,8,284,https://pilkada2015.kpu.go.id/surabayakota/sawahan/petemon
TPS 47,417,225,38,182,220,5,225,https://pilkada2015.kpu.go.id/surabayakota/sawahan/petemon
TPS 48,663,355,33,313,346,9,355,https://pilkada2015.kpu.go.id/surabayakota/sawahan/petemon
TPS 49,772,351,24,321,345,6,351,https://pilkada2015.kpu.go.id/surabayakota/sawahan/petemon
TPS 50,775,398,33,361,394,4,398,https://pilkada2015.kpu.go.id/surabayakota/sawahan/petemon
TPS 51,627,256,18,237,255,1,256,https://pilkada2015.kpu.go.id/surabayakota/sawahan/petemon
TPS 52,766,395,53,329,382,13,395,https://pilkada2015.kpu.go.id/surabayakota/sawahan/petemon
TPS 1,547,237,19,214,233,4,237,https://pilkada2015.kpu.go.id/surabayakota/sawahan/putat_jaya
TPS 2,521,296,37,256,293,3,296,https://pilkada2015.kpu.go.id/surabayakota/sawahan/putat_jaya
TPS 3,608,256,39,210,249,7,256,https://pilkada2015.kpu.go.id/surabayakota/sawahan/putat_jaya
TPS 4,580,238,72,164,236,2,238,https://pilkada2015.kpu.go.id/surabayakota/sawahan/putat_jaya
TPS 5,461,301,53,245,298,3,301,https://pilkada2015.kpu.go.id/surabayakota/sawahan/putat_jaya
TPS 6,501,290,31,253,284,6,290,https://pilkada2015.kpu.go.id/surabayakota/sawahan/putat_jaya
TPS 7,438,249,34,211,245,4,249,https://pilkada2015.kpu.go.id/surabayakota/sawahan/putat_jaya
TPS 8,539,287,54,230,284,3,287,https://pilkada2015.kpu.go.id/surabayakota/sawahan/putat_jaya
TPS 9,491,227,62,162,224,3,227,https://pilkada2015.kpu.go.id/surabayakota/sawahan/putat_jaya
TPS 10,536,295,62,227,289,6,295,https://pilkada2015.kpu.go.id/surabayakota/sawahan/putat_jaya
TPS 11,537,256,80,170,250,6,256,https://pilkada2015.kpu.go.id/surabayakota/sawahan/putat_jaya
TPS 12,573,280,91,177,268,12,280,https://pilkada2015.kpu.go.id/surabayakota/sawahan/putat_jaya
TPS 13,571,258,52,198,250,8,258,https://pilkada2015.kpu.go.id/surabayakota/sawahan/putat_jaya
TPS 14,364,186,35,149,184,2,186,https://pilkada2015.kpu.go.id/surabayakota/sawahan/putat_jaya
TPS 15,526,286,57,226,283,3,286,https://pilkada2015.kpu.go.id/surabayakota/sawahan/putat_jaya
TPS 16,416,243,38,195,233,10,243,https://pilkada2015.kpu.go.id/surabayakota/sawahan/putat_jaya
TPS 17,290,170,22,144,166,4,170,https://pilkada2015.kpu.go.id/surabayakota/sawahan/putat_jaya
TPS 18,449,281,31,248,279,2,281,https://pilkada2015.kpu.go.id/surabayakota/sawahan/putat_jaya
TPS 19,438,286,44,238,282,4,286,https://pilkada2015.kpu.go.id/surabayakota/sawahan/putat_jaya
TPS 20,411,239,43,194,237,2,239,https://pilkada2015.kpu.go.id/surabayakota/sawahan/putat_jaya
TPS 21,424,223,42,177,219,4,223,https://pilkada2015.kpu.go.id/surabayakota/sawahan/putat_jaya
TPS 22,0,218,48,160,208,10,218,https://pilkada2015.kpu.go.id/surabayakota/sawahan/putat_jaya
TPS 23,511,283,46,229,275,8,283,https://pilkada2015.kpu.go.id/surabayakota/sawahan/putat_jaya
TPS 24,524,296,68,221,289,7,296,https://pilkada2015.kpu.go.id/surabayakota/sawahan/putat_jaya
TPS 25,529,269,77,187,264,5,269,https://pilkada2015.kpu.go.id/surabayakota/sawahan/putat_jaya
TPS 26,493,267,48,214,262,5,267,https://pilkada2015.kpu.go.id/surabayakota/sawahan/putat_jaya
TPS 27,476,235,55,170,225,10,235,https://pilkada2015.kpu.go.id/surabayakota/sawahan/putat_jaya
TPS 28,476,250,44,202,246,4,250,https://pilkada2015.kpu.go.id/surabayakota/sawahan/putat_jaya
TPS 29,505,300,113,177,290,10,300,https://pilkada2015.kpu.go.id/surabayakota/sawahan/putat_jaya
TPS 30,529,232,41,187,228,4,232,https://pilkada2015.kpu.go.id/surabayakota/sawahan/putat_jaya
TPS 31,464,248,60,177,237,11,248,https://pilkada2015.kpu.go.id/surabayakota/sawahan/putat_jaya
TPS 32,523,221,50,166,216,5,221,https://pilkada2015.kpu.go.id/surabayakota/sawahan/putat_jaya
TPS 33,518,305,49,251,300,5,305,https://pilkada2015.kpu.go.id/surabayakota/sawahan/putat_jaya
TPS 34,634,340,36,297,333,7,340,https://pilkada2015.kpu.go.id/surabayakota/sawahan/putat_jaya
TPS 35,479,263,33,222,255,8,263,https://pilkada2015.kpu.go.id/surabayakota/sawahan/putat_jaya
TPS 36,678,284,47,230,277,7,284,https://pilkada2015.kpu.go.id/surabayakota/sawahan/putat_jaya
TPS 37,534,290,50,231,281,9,290,https://pilkada2015.kpu.go.id/surabayakota/sawahan/putat_jaya
TPS 38,512,344,42,294,336,8,344,https://pilkada2015.kpu.go.id/surabayakota/sawahan/putat_jaya
TPS 39,683,229,70,151,221,8,229,https://pilkada2015.kpu.go.id/surabayakota/sawahan/putat_jaya
TPS 40,498,240,44,192,236,4,240,https://pilkada2015.kpu.go.id/surabayakota/sawahan/putat_jaya
TPS 41,448,201,48,148,196,5,201,https://pilkada2015.kpu.go.id/surabayakota/sawahan/putat_jaya
TPS 42,541,259,40,214,254,5,259,https://pilkada2015.kpu.go.id/surabayakota/sawahan/putat_jaya
TPS 43,565,275,29,244,273,2,275,https://pilkada2015.kpu.go.id/surabayakota/sawahan/putat_jaya
TPS 44,554,235,116,110,226,9,235,https://pilkada2015.kpu.go.id/surabayakota/sawahan/putat_jaya
TPS 45,624,241,79,146,225,16,241,https://pilkada2015.kpu.go.id/surabayakota/sawahan/putat_jaya
TPS 46,391,230,135,90,225,5,230,https://pilkada2015.kpu.go.id/surabayakota/sawahan/putat_jaya
TPS 47,425,244,69,164,233,9,242,https://pilkada2015.kpu.go.id/surabayakota/sawahan/putat_jaya
TPS 48,574,234,54,178,232,2,234,https://pilkada2015.kpu.go.id/surabayakota/sawahan/putat_jaya
TPS 49,605,290,91,189,280,10,290,https://pilkada2015.kpu.go.id/surabayakota/sawahan/putat_jaya
TPS 50,635,227,73,145,218,9,227,https://pilkada2015.kpu.go.id/surabayakota/sawahan/putat_jaya
TPS 51,484,250,58,186,244,6,250,https://pilkada2015.kpu.go.id/surabayakota/sawahan/putat_jaya
TPS 52,500,241,52,178,230,11,241,https://pilkada2015.kpu.go.id/surabayakota/sawahan/putat_jaya
TPS 53,464,214,54,154,208,6,214,https://pilkada2015.kpu.go.id/surabayakota/sawahan/putat_jaya
TPS 54,520,248,58,181,239,9,248,https://pilkada2015.kpu.go.id/surabayakota/sawahan/putat_jaya
TPS 55,499,215,59,150,209,6,215,https://pilkada2015.kpu.go.id/surabayakota/sawahan/putat_jaya
TPS 56,416,196,29,157,186,10,196,https://pilkada2015.kpu.go.id/surabayakota/sawahan/putat_jaya
TPS 57,654,341,53,279,332,9,341,https://pilkada2015.kpu.go.id/surabayakota/sawahan/putat_jaya
TPS 58,570,271,27,240,267,4,271,https://pilkada2015.kpu.go.id/surabayakota/sawahan/putat_jaya
TPS 59,593,304,37,261,298,6,304,https://pilkada2015.kpu.go.id/surabayakota/sawahan/putat_jaya
TPS 60,420,252,33,213,246,6,252,https://pilkada2015.kpu.go.id/surabayakota/sawahan/putat_jaya
TPS 61,548,313,37,273,310,3,313,https://pilkada2015.kpu.go.id/surabayakota/sawahan/putat_jaya
TPS 62,457,287,53,227,280,7,287,https://pilkada2015.kpu.go.id/surabayakota/sawahan/putat_jaya
TPS 63,421,315,49,260,309,6,315,https://pilkada2015.kpu.go.id/surabayakota/sawahan/putat_jaya
TPS 64,511,350,52,291,343,7,350,https://pilkada2015.kpu.go.id/surabayakota/sawahan/putat_jaya
TPS 1,722,335,37,292,329,6,335,https://pilkada2015.kpu.go.id/surabayakota/sawahan/sawahan
TPS 2,603,332,59,258,317,15,332,https://pilkada2015.kpu.go.id/surabayakota/sawahan/sawahan
TPS 3,513,303,42,255,297,6,303,https://pilkada2015.kpu.go.id/surabayakota/sawahan/sawahan
TPS 4,639,353,40,307,347,6,353,https://pilkada2015.kpu.go.id/surabayakota/sawahan/sawahan
TPS 5,428,267,66,197,263,4,267,https://pilkada2015.kpu.go.id/surabayakota/sawahan/sawahan
TPS 6,467,275,43,227,270,5,275,https://pilkada2015.kpu.go.id/surabayakota/sawahan/sawahan
TPS 7,661,274,27,240,267,7,274,https://pilkada2015.kpu.go.id/surabayakota/sawahan/sawahan
TPS 8,436,271,22,242,264,7,271,https://pilkada2015.kpu.go.id/surabayakota/sawahan/sawahan
TPS 9,414,225,33,189,222,3,225,https://pilkada2015.kpu.go.id/surabayakota/sawahan/sawahan
TPS 10,596,320,42,273,315,5,320,https://pilkada2015.kpu.go.id/surabayakota/sawahan/sawahan
TPS 11,429,147,8,139,147,0,147,https://pilkada2015.kpu.go.id/surabayakota/sawahan/sawahan
TPS 12,384,120,7,112,119,1,120,https://pilkada2015.kpu.go.id/surabayakota/sawahan/sawahan
TPS 13,431,170,14,156,170,0,170,https://pilkada2015.kpu.go.id/surabayakota/sawahan/sawahan
TPS 14,180,72,5,66,71,1,72,https://pilkada2015.kpu.go.id/surabayakota/sawahan/sawahan
TPS 15,540,241,29,203,232,9,241,https://pilkada2015.kpu.go.id/surabayakota/sawahan/sawahan
TPS 16,483,285,19,255,274,11,285,https://pilkada2015.kpu.go.id/surabayakota/sawahan/sawahan
TPS 17,320,151,14,136,150,1,151,https://pilkada2015.kpu.go.id/surabayakota/sawahan/sawahan
TPS 18,485,229,36,185,221,8,229,https://pilkada2015.kpu.go.id/surabayakota/sawahan/sawahan
TPS 19,447,161,32,123,155,6,161,https://pilkada2015.kpu.go.id/surabayakota/sawahan/sawahan
TPS 20,646,310,49,255,304,6,310,https://pilkada2015.kpu.go.id/surabayakota/sawahan/sawahan
TPS 21,653,331,43,283,326,5,331,https://pilkada2015.kpu.go.id/surabayakota/sawahan/sawahan
TPS 22,437,193,36,152,188,5,193,https://pilkada2015.kpu.go.id/surabayakota/sawahan/sawahan
TPS 23,444,233,54,178,232,1,233,https://pilkada2015.kpu.go.id/surabayakota/sawahan/sawahan
TPS 24,519,292,38,243,281,11,292,https://pilkada2015.kpu.go.id/surabayakota/sawahan/sawahan
TPS 25,484,258,41,213,254,4,258,https://pilkada2015.kpu.go.id/surabayakota/sawahan/sawahan
TPS 26,542,291,41,241,282,9,291,https://pilkada2015.kpu.go.id/surabayakota/sawahan/sawahan
TPS 27,543,302,57,242,299,3,302,https://pilkada2015.kpu.go.id/surabayakota/sawahan/sawahan
TPS 28,632,267,46,219,265,2,267,https://pilkada2015.kpu.go.id/surabayakota/sawahan/sawahan
TPS 29,666,334,38,291,329,5,334,https://pilkada2015.kpu.go.id/surabayakota/sawahan/sawahan
TPS 30,241,132,11,121,132,0,132,https://pilkada2015.kpu.go.id/surabayakota/sawahan/sawahan
TPS 1,702,322,9,311,320,2,322,https://pilkada2015.kpu.go.id/surabayakota/semampir/ampel
TPS 2,631,258,26,230,256,2,258,https://pilkada2015.kpu.go.id/surabayakota/semampir/ampel
TPS 3,597,265,18,241,259,6,265,https://pilkada2015.kpu.go.id/surabayakota/semampir/ampel
TPS 4,573,265,26,237,263,2,265,https://pilkada2015.kpu.go.id/surabayakota/semampir/ampel
TPS 5,514,197,18,177,195,2,197,https://pilkada2015.kpu.go.id/surabayakota/semampir/ampel
TPS 6,418,178,51,125,176,2,178,https://pilkada2015.kpu.go.id/surabayakota/semampir/ampel
TPS 7,478,214,19,188,207,7,214,https://pilkada2015.kpu.go.id/surabayakota/semampir/ampel
TPS 8,523,257,27,226,253,4,257,https://pilkada2015.kpu.go.id/surabayakota/semampir/ampel
TPS 9,470,215,40,169,209,6,215,https://pilkada2015.kpu.go.id/surabayakota/semampir/ampel
TPS 10,493,135,20,110,130,5,135,https://pilkada2015.kpu.go.id/surabayakota/semampir/ampel
TPS 11,425,221,41,179,220,1,221,https://pilkada2015.kpu.go.id/surabayakota/semampir/ampel
TPS 12,509,186,69,112,181,5,186,https://pilkada2015.kpu.go.id/surabayakota/semampir/ampel
TPS 13,476,240,17,217,234,6,240,https://pilkada2015.kpu.go.id/surabayakota/semampir/ampel
TPS 14,584,251,27,219,246,5,251,https://pilkada2015.kpu.go.id/surabayakota/semampir/ampel
TPS 15,564,255,37,214,251,4,255,https://pilkada2015.kpu.go.id/surabayakota/semampir/ampel
TPS 16,529,212,26,184,210,2,212,https://pilkada2015.kpu.go.id/surabayakota/semampir/ampel
TPS 17,600,254,29,218,247,7,254,https://pilkada2015.kpu.go.id/surabayakota/semampir/ampel
TPS 18,764,244,30,205,0,0,0,https://pilkada2015.kpu.go.id/surabayakota/semampir/ampel
TPS 19,567,243,23,214,237,6,243,https://pilkada2015.kpu.go.id/surabayakota/semampir/ampel
TPS 20,511,283,39,242,281,2,283,https://pilkada2015.kpu.go.id/surabayakota/semampir/ampel
TPS 21,518,247,62,183,245,2,247,https://pilkada2015.kpu.go.id/surabayakota/semampir/ampel
TPS 22,595,180,34,142,176,4,180,https://pilkada2015.kpu.go.id/surabayakota/semampir/ampel
TPS 23,569,240,28,204,232,8,240,https://pilkada2015.kpu.go.id/surabayakota/semampir/ampel
TPS 24,616,264,48,204,252,12,264,https://pilkada2015.kpu.go.id/surabayakota/semampir/ampel
TPS 25,682,246,26,217,243,3,246,https://pilkada2015.kpu.go.id/surabayakota/semampir/ampel
TPS 26,392,160,17,138,155,5,160,https://pilkada2015.kpu.go.id/surabayakota/semampir/ampel
TPS 27,318,131,28,100,128,3,131,https://pilkada2015.kpu.go.id/surabayakota/semampir/ampel
TPS 28,268,116,47,64,111,5,116,https://pilkada2015.kpu.go.id/surabayakota/semampir/ampel
TPS 1,415,129,37,88,125,4,129,https://pilkada2015.kpu.go.id/surabayakota/semampir/pegirian
TPS 2,443,159,34,116,150,9,159,https://pilkada2015.kpu.go.id/surabayakota/semampir/pegirian
TPS 3,609,160,35,124,159,1,160,https://pilkada2015.kpu.go.id/surabayakota/semampir/pegirian
TPS 4,689,150,42,105,147,3,150,https://pilkada2015.kpu.go.id/surabayakota/semampir/pegirian
TPS 5,473,170,38,130,168,2,170,https://pilkada2015.kpu.go.id/surabayakota/semampir/pegirian
TPS 6,546,110,37,72,109,1,110,https://pilkada2015.kpu.go.id/surabayakota/semampir/pegirian
TPS 7,612,111,35,75,110,1,111,https://pilkada2015.kpu.go.id/surabayakota/semampir/pegirian
TPS 8,588,183,37,142,179,4,183,https://pilkada2015.kpu.go.id/surabayakota/semampir/pegirian
TPS 9,443,182,27,152,179,3,182,https://pilkada2015.kpu.go.id/surabayakota/semampir/pegirian
TPS 10,470,178,33,139,172,6,178,https://pilkada2015.kpu.go.id/surabayakota/semampir/pegirian
TPS 11,384,143,18,120,138,5,143,https://pilkada2015.kpu.go.id/surabayakota/semampir/pegirian
TPS 12,466,167,25,138,163,4,167,https://pilkada2015.kpu.go.id/surabayakota/semampir/pegirian
TPS 13,614,242,31,206,237,5,242,https://pilkada2015.kpu.go.id/surabayakota/semampir/pegirian
TPS 14,630,228,49,175,224,4,228,https://pilkada2015.kpu.go.id/surabayakota/semampir/pegirian
TPS 15,635,239,38,196,234,5,239,https://pilkada2015.kpu.go.id/surabayakota/semampir/pegirian
TPS 16,725,337,37,296,333,4,337,https://pilkada2015.kpu.go.id/surabayakota/semampir/pegirian
TPS 17,498,232,24,204,228,4,232,https://pilkada2015.kpu.go.id/surabayakota/semampir/pegirian
TPS 18,487,487,41,212,253,9,262,https://pilkada2015.kpu.go.id/surabayakota/semampir/pegirian
TPS 19,484,250,42,200,242,8,250,https://pilkada2015.kpu.go.id/surabayakota/semampir/pegirian
TPS 20,404,186,38,142,180,6,186,https://pilkada2015.kpu.go.id/surabayakota/semampir/pegirian
TPS 21,445,152,20,131,151,1,152,https://pilkada2015.kpu.go.id/surabayakota/semampir/pegirian
TPS 22,533,299,30,262,292,7,299,https://pilkada2015.kpu.go.id/surabayakota/semampir/pegirian
TPS 23,565,324,19,303,322,2,324,https://pilkada2015.kpu.go.id/surabayakota/semampir/pegirian
TPS 24,614,328,26,294,320,8,328,https://pilkada2015.kpu.go.id/surabayakota/semampir/pegirian
TPS 25,392,201,14,185,199,2,201,https://pilkada2015.kpu.go.id/surabayakota/semampir/pegirian
TPS 26,459,183,22,158,180,3,183,https://pilkada2015.kpu.go.id/surabayakota/semampir/pegirian
TPS 27,470,210,29,174,203,7,210,https://pilkada2015.kpu.go.id/surabayakota/semampir/pegirian
TPS 28,609,278,23,253,276,2,278,https://pilkada2015.kpu.go.id/surabayakota/semampir/pegirian
TPS 29,470,239,33,205,238,1,239,https://pilkada2015.kpu.go.id/surabayakota/semampir/pegirian
TPS 30,514,284,28,253,281,3,284,https://pilkada2015.kpu.go.id/surabayakota/semampir/pegirian
TPS 31,452,248,27,219,246,2,248,https://pilkada2015.kpu.go.id/surabayakota/semampir/pegirian
TPS 32,549,269,47,220,267,2,269,https://pilkada2015.kpu.go.id/surabayakota/semampir/pegirian
TPS 33,383,227,30,196,226,1,227,https://pilkada2015.kpu.go.id/surabayakota/semampir/pegirian
TPS 34,474,238,20,212,232,6,238,https://pilkada2015.kpu.go.id/surabayakota/semampir/pegirian
TPS 35,729,222,79,139,218,4,222,https://pilkada2015.kpu.go.id/surabayakota/semampir/pegirian
TPS 36,531,194,25,168,193,1,194,https://pilkada2015.kpu.go.id/surabayakota/semampir/pegirian
TPS 37,690,247,52,190,242,5,247,https://pilkada2015.kpu.go.id/surabayakota/semampir/pegirian
TPS 38,569,159,15,140,155,4,159,https://pilkada2015.kpu.go.id/surabayakota/semampir/pegirian
TPS 39,549,151,20,130,150,1,151,https://pilkada2015.kpu.go.id/surabayakota/semampir/pegirian
TPS 40,431,149,25,119,144,5,149,https://pilkada2015.kpu.go.id/surabayakota/semampir/pegirian
TPS 41,557,271,44,218,262,9,271,https://pilkada2015.kpu.go.id/surabayakota/semampir/pegirian
TPS 42,632,237,112,123,235,2,237,https://pilkada2015.kpu.go.id/surabayakota/semampir/pegirian
TPS 1,564,201,33,167,200,1,201,https://pilkada2015.kpu.go.id/surabayakota/semampir/sidotopo
TPS 2,486,99,24,73,97,2,99,https://pilkada2015.kpu.go.id/surabayakota/semampir/sidotopo
TPS 3,672,241,39,196,235,6,241,https://pilkada2015.kpu.go.id/surabayakota/semampir/sidotopo
TPS 4,528,151,43,108,151,0,151,https://pilkada2015.kpu.go.id/surabayakota/semampir/sidotopo
TPS 5,517,205,20,185,205,0,205,https://pilkada2015.kpu.go.id/surabayakota/semampir/sidotopo
TPS 6,540,258,26,231,257,1,258,https://pilkada2015.kpu.go.id/surabayakota/semampir/sidotopo
TPS 7,509,260,14,241,255,5,260,https://pilkada2015.kpu.go.id/surabayakota/semampir/sidotopo
TPS 8,514,296,33,263,296,0,296,https://pilkada2015.kpu.go.id/surabayakota/semampir/sidotopo
TPS 9,553,280,50,226,276,4,280,https://pilkada2015.kpu.go.id/surabayakota/semampir/sidotopo
TPS 10,449,200,23,177,200,0,200,https://pilkada2015.kpu.go.id/surabayakota/semampir/sidotopo
TPS 11,383,195,26,164,190,5,195,https://pilkada2015.kpu.go.id/surabayakota/semampir/sidotopo
TPS 12,361,192,15,173,188,4,192,https://pilkada2015.kpu.go.id/surabayakota/semampir/sidotopo
TPS 13,501,229,23,199,222,7,229,https://pilkada2015.kpu.go.id/surabayakota/semampir/sidotopo
TPS 14,560,221,35,184,219,2,221,https://pilkada2015.kpu.go.id/surabayakota/semampir/sidotopo
TPS 15,433,189,24,162,186,3,189,https://pilkada2015.kpu.go.id/surabayakota/semampir/sidotopo
TPS 16,642,282,40,235,275,7,282,https://pilkada2015.kpu.go.id/surabayakota/semampir/sidotopo
TPS 17,584,283,27,251,198,5,283,https://pilkada2015.kpu.go.id/surabayakota/semampir/sidotopo
TPS 18,536,257,33,221,254,3,257,https://pilkada2015.kpu.go.id/surabayakota/semampir/sidotopo
TPS 19,458,194,17,171,188,6,194,https://pilkada2015.kpu.go.id/surabayakota/semampir/sidotopo
TPS 20,718,223,56,161,217,6,223,https://pilkada2015.kpu.go.id/surabayakota/semampir/sidotopo
TPS 21,679,227,37,186,223,4,227,https://pilkada2015.kpu.go.id/surabayakota/semampir/sidotopo
TPS 22,753,199,87,106,193,6,199,https://pilkada2015.kpu.go.id/surabayakota/semampir/sidotopo
TPS 23,467,217,21,190,211,6,217,https://pilkada2015.kpu.go.id/surabayakota/semampir/sidotopo
TPS 24,609,267,48,217,265,2,267,https://pilkada2015.kpu.go.id/surabayakota/semampir/sidotopo
TPS 25,491,218,0,0,211,7,218,https://pilkada2015.kpu.go.id/surabayakota/semampir/sidotopo
TPS 26,480,192,35,150,185,7,192,https://pilkada2015.kpu.go.id/surabayakota/semampir/sidotopo
TPS 27,650,271,37,234,271,0,271,https://pilkada2015.kpu.go.id/surabayakota/semampir/sidotopo
TPS 28,741,266,35,225,260,6,266,https://pilkada2015.kpu.go.id/surabayakota/semampir/sidotopo
TPS 29,501,253,21,224,245,8,253,https://pilkada2015.kpu.go.id/surabayakota/semampir/sidotopo
TPS 30,425,192,21,169,190,2,192,https://pilkada2015.kpu.go.id/surabayakota/semampir/sidotopo
TPS 31,596,257,27,225,252,5,257,https://pilkada2015.kpu.go.id/surabayakota/semampir/sidotopo
TPS 32,453,210,32,175,207,3,210,https://pilkada2015.kpu.go.id/surabayakota/semampir/sidotopo
TPS 33,541,0,39,184,223,4,227,https://pilkada2015.kpu.go.id/surabayakota/semampir/sidotopo
TPS 34,585,224,51,170,221,3,224,https://pilkada2015.kpu.go.id/surabayakota/semampir/sidotopo
TPS 35,635,214,81,129,210,4,214,https://pilkada2015.kpu.go.id/surabayakota/semampir/sidotopo
TPS 36,604,192,32,157,189,3,192,https://pilkada2015.kpu.go.id/surabayakota/semampir/sidotopo
TPS 37,449,212,62,142,204,8,212,https://pilkada2015.kpu.go.id/surabayakota/semampir/sidotopo
TPS 38,516,232,19,210,229,3,232,https://pilkada2015.kpu.go.id/surabayakota/semampir/sidotopo
TPS 39,423,182,24,153,177,5,182,https://pilkada2015.kpu.go.id/surabayakota/semampir/sidotopo
TPS 40,542,234,41,188,229,5,234,https://pilkada2015.kpu.go.id/surabayakota/semampir/sidotopo
TPS 41,499,248,28,218,246,2,248,https://pilkada2015.kpu.go.id/surabayakota/semampir/sidotopo
TPS 42,469,214,16,192,208,6,214,https://pilkada2015.kpu.go.id/surabayakota/semampir/sidotopo
TPS 43,522,236,49,181,230,6,236,https://pilkada2015.kpu.go.id/surabayakota/semampir/sidotopo
TPS 1,624,181,8,172,180,1,181,https://pilkada2015.kpu.go.id/surabayakota/semampir/ujung
TPS 2,587,318,16,300,316,2,318,https://pilkada2015.kpu.go.id/surabayakota/semampir/ujung
TPS 3,714,220,32,182,214,6,220,https://pilkada2015.kpu.go.id/surabayakota/semampir/ujung
TPS 4,531,207,98,106,204,3,207,https://pilkada2015.kpu.go.id/surabayakota/semampir/ujung
TPS 5,502,236,47,184,231,5,236,https://pilkada2015.kpu.go.id/surabayakota/semampir/ujung
TPS 6,352,181,72,104,176,5,181,https://pilkada2015.kpu.go.id/surabayakota/semampir/ujung
TPS 7,331,125,40,81,121,4,125,https://pilkada2015.kpu.go.id/surabayakota/semampir/ujung
TPS 8,389,163,58,98,156,7,163,https://pilkada2015.kpu.go.id/surabayakota/semampir/ujung
TPS 9,662,234,56,174,230,4,234,https://pilkada2015.kpu.go.id/surabayakota/semampir/ujung
TPS 10,480,338,46,290,336,2,338,https://pilkada2015.kpu.go.id/surabayakota/semampir/ujung
TPS 11,572,153,45,104,149,4,153,https://pilkada2015.kpu.go.id/surabayakota/semampir/ujung
TPS 12,0,191,39,150,189,2,191,https://pilkada2015.kpu.go.id/surabayakota/semampir/ujung
TPS 13,627,203,35,165,200,3,203,https://pilkada2015.kpu.go.id/surabayakota/semampir/ujung
TPS 14,568,127,22,104,126,1,127,https://pilkada2015.kpu.go.id/surabayakota/semampir/ujung
TPS 15,592,137,19,116,135,2,137,https://pilkada2015.kpu.go.id/surabayakota/semampir/ujung
TPS 16,369,83,15,66,81,2,83,https://pilkada2015.kpu.go.id/surabayakota/semampir/ujung
TPS 17,479,146,43,100,143,3,146,https://pilkada2015.kpu.go.id/surabayakota/semampir/ujung
TPS 18,499,143,42,98,140,3,140,https://pilkada2015.kpu.go.id/surabayakota/semampir/ujung
TPS 19,466,116,26,86,112,4,116,https://pilkada2015.kpu.go.id/surabayakota/semampir/ujung
TPS 20,438,164,24,138,162,2,164,https://pilkada2015.kpu.go.id/surabayakota/semampir/ujung
TPS 21,485,106,19,84,103,3,106,https://pilkada2015.kpu.go.id/surabayakota/semampir/ujung
TPS 22,586,77,23,51,74,3,77,https://pilkada2015.kpu.go.id/surabayakota/semampir/ujung
TPS 23,465,53,35,18,53,0,53,https://pilkada2015.kpu.go.id/surabayakota/semampir/ujung
TPS 24,394,73,24,47,71,2,73,https://pilkada2015.kpu.go.id/surabayakota/semampir/ujung
TPS 25,557,154,49,100,149,5,154,https://pilkada2015.kpu.go.id/surabayakota/semampir/ujung
TPS 26,601,145,32,110,142,3,145,https://pilkada2015.kpu.go.id/surabayakota/semampir/ujung
TPS 27,578,81,11,69,80,1,81,https://pilkada2015.kpu.go.id/surabayakota/semampir/ujung
TPS 28,606,193,40,148,188,5,193,https://pilkada2015.kpu.go.id/surabayakota/semampir/ujung
TPS 29,618,183,29,146,175,8,183,https://pilkada2015.kpu.go.id/surabayakota/semampir/ujung
TPS 30,610,194,40,152,192,2,194,https://pilkada2015.kpu.go.id/surabayakota/semampir/ujung
TPS 31,456,153,29,123,152,1,153,https://pilkada2015.kpu.go.id/surabayakota/semampir/ujung
TPS 32,558,558,31,154,185,4,189,https://pilkada2015.kpu.go.id/surabayakota/semampir/ujung
TPS 33,567,193,44,143,187,6,193,https://pilkada2015.kpu.go.id/surabayakota/semampir/ujung
TPS 34,587,192,62,128,190,2,192,https://pilkada2015.kpu.go.id/surabayakota/semampir/ujung
TPS 35,184,184,36,144,180,4,184,https://pilkada2015.kpu.go.id/surabayakota/semampir/ujung
TPS 36,586,149,17,128,145,4,149,https://pilkada2015.kpu.go.id/surabayakota/semampir/ujung
TPS 37,573,168,45,120,165,3,168,https://pilkada2015.kpu.go.id/surabayakota/semampir/ujung
TPS 38,480,192,30,160,190,2,192,https://pilkada2015.kpu.go.id/surabayakota/semampir/ujung
TPS 39,581,270,57,206,263,7,270,https://pilkada2015.kpu.go.id/surabayakota/semampir/ujung
TPS 40,555,210,28,176,204,6,210,https://pilkada2015.kpu.go.id/surabayakota/semampir/ujung
TPS 41,555,281,22,257,279,2,281,https://pilkada2015.kpu.go.id/surabayakota/semampir/ujung
TPS 42,639,330,35,289,324,6,330,https://pilkada2015.kpu.go.id/surabayakota/semampir/ujung
TPS 43,579,260,20,238,258,2,260,https://pilkada2015.kpu.go.id/surabayakota/semampir/ujung
TPS 44,573,153,52,100,152,1,153,https://pilkada2015.kpu.go.id/surabayakota/semampir/ujung
TPS 45,578,142,57,83,140,2,142,https://pilkada2015.kpu.go.id/surabayakota/semampir/ujung
TPS 46,489,256,36,219,255,1,256,https://pilkada2015.kpu.go.id/surabayakota/semampir/ujung
TPS 47,0,0,0,0,0,0,0,https://pilkada2015.kpu.go.id/surabayakota/semampir/ujung
TPS 1,535,205,25,180,205,0,205,https://pilkada2015.kpu.go.id/surabayakota/semampir/wonokusumo
TPS 2,355,121,9,111,120,1,121,https://pilkada2015.kpu.go.id/surabayakota/semampir/wonokusumo
TPS 3,533,209,36,164,200,9,209,https://pilkada2015.kpu.go.id/surabayakota/semampir/wonokusumo
TPS 4,395,162,33,125,158,4,162,https://pilkada2015.kpu.go.id/surabayakota/semampir/wonokusumo
TPS 5,421,199,17,179,196,3,199,https://pilkada2015.kpu.go.id/surabayakota/semampir/wonokusumo
TPS 6,558,187,30,156,186,1,187,https://pilkada2015.kpu.go.id/surabayakota/semampir/wonokusumo
TPS 7,575,214,30,182,212,2,214,https://pilkada2015.kpu.go.id/surabayakota/semampir/wonokusumo
TPS 8,649,279,46,229,275,4,279,https://pilkada2015.kpu.go.id/surabayakota/semampir/wonokusumo
TPS 9,449,165,40,119,159,6,165,https://pilkada2015.kpu.go.id/surabayakota/semampir/wonokusumo
TPS 10,570,311,27,281,308,3,311,https://pilkada2015.kpu.go.id/surabayakota/semampir/wonokusumo
TPS 11,504,248,27,220,247,1,248,https://pilkada2015.kpu.go.id/surabayakota/semampir/wonokusumo
TPS 12,630,285,43,236,279,6,285,https://pilkada2015.kpu.go.id/surabayakota/semampir/wonokusumo
TPS 13,558,304,26,275,301,3,304,https://pilkada2015.kpu.go.id/surabayakota/semampir/wonokusumo
TPS 14,598,311,43,262,305,6,311,https://pilkada2015.kpu.go.id/surabayakota/semampir/wonokusumo
TPS 15,426,206,27,171,198,8,206,https://pilkada2015.kpu.go.id/surabayakota/semampir/wonokusumo
TPS 16,499,249,43,203,246,3,249,https://pilkada2015.kpu.go.id/surabayakota/semampir/wonokusumo
TPS 17,703,247,41,199,240,7,247,https://pilkada2015.kpu.go.id/surabayakota/semampir/wonokusumo
TPS 18,401,143,25,116,141,2,143,https://pilkada2015.kpu.go.id/surabayakota/semampir/wonokusumo
TPS 19,668,203,17,180,197,6,203,https://pilkada2015.kpu.go.id/surabayakota/semampir/wonokusumo
TPS 20,482,178,23,155,178,0,178,https://pilkada2015.kpu.go.id/surabayakota/semampir/wonokusumo
TPS 21,501,195,27,165,192,3,195,https://pilkada2015.kpu.go.id/surabayakota/semampir/wonokusumo
TPS 22,577,277,26,249,275,2,277,https://pilkada2015.kpu.go.id/surabayakota/semampir/wonokusumo
TPS 23,592,291,26,259,285,6,291,https://pilkada2015.kpu.go.id/surabayakota/semampir/wonokusumo
TPS 24,0,296,37,258,295,1,296,https://pilkada2015.kpu.go.id/surabayakota/semampir/wonokusumo
TPS 25,525,250,18,230,248,2,250,https://pilkada2015.kpu.go.id/surabayakota/semampir/wonokusumo
TPS 26,442,239,33,204,237,2,239,https://pilkada2015.kpu.go.id/surabayakota/semampir/wonokusumo
TPS 27,543,237,34,197,231,6,237,https://pilkada2015.kpu.go.id/surabayakota/semampir/wonokusumo
TPS 28,569,319,39,274,313,6,319,https://pilkada2015.kpu.go.id/surabayakota/semampir/wonokusumo
TPS 29,495,241,51,186,237,4,241,https://pilkada2015.kpu.go.id/surabayakota/semampir/wonokusumo
TPS 30,524,210,28,177,205,5,210,https://pilkada2015.kpu.go.id/surabayakota/semampir/wonokusumo
TPS 31,593,201,18,180,198,3,201,https://pilkada2015.kpu.go.id/surabayakota/semampir/wonokusumo
TPS 32,559,203,51,152,203,0,203,https://pilkada2015.kpu.go.id/surabayakota/semampir/wonokusumo
TPS 33,467,240,33,201,234,6,240,https://pilkada2015.kpu.go.id/surabayakota/semampir/wonokusumo
TPS 34,639,297,46,247,293,4,297,https://pilkada2015.kpu.go.id/surabayakota/semampir/wonokusumo
TPS 35,707,300,47,248,295,5,300,https://pilkada2015.kpu.go.id/surabayakota/semampir/wonokusumo
TPS 36,589,246,41,202,243,3,246,https://pilkada2015.kpu.go.id/surabayakota/semampir/wonokusumo
TPS 37,590,210,34,173,207,3,210,https://pilkada2015.kpu.go.id/surabayakota/semampir/wonokusumo
TPS 38,519,208,60,146,206,2,208,https://pilkada2015.kpu.go.id/surabayakota/semampir/wonokusumo
TPS 39,433,207,56,144,200,7,207,https://pilkada2015.kpu.go.id/surabayakota/semampir/wonokusumo
TPS 40,327,174,12,160,0,0,0,https://pilkada2015.kpu.go.id/surabayakota/semampir/wonokusumo
TPS 41,558,268,17,247,264,4,268,https://pilkada2015.kpu.go.id/surabayakota/semampir/wonokusumo
TPS 42,586,250,19,229,248,2,250,https://pilkada2015.kpu.go.id/surabayakota/semampir/wonokusumo
TPS 43,624,255,20,229,249,6,255,https://pilkada2015.kpu.go.id/surabayakota/semampir/wonokusumo
TPS 44,623,277,67,201,268,9,277,https://pilkada2015.kpu.go.id/surabayakota/semampir/wonokusumo
TPS 45,555,189,47,138,185,4,189,https://pilkada2015.kpu.go.id/surabayakota/semampir/wonokusumo
TPS 46,652,229,38,190,228,1,229,https://pilkada2015.kpu.go.id/surabayakota/semampir/wonokusumo
TPS 47,655,238,37,194,231,7,238,https://pilkada2015.kpu.go.id/surabayakota/semampir/wonokusumo
TPS 48,517,232,31,192,223,9,232,https://pilkada2015.kpu.go.id/surabayakota/semampir/wonokusumo
TPS 49,589,206,46,154,200,6,206,https://pilkada2015.kpu.go.id/surabayakota/semampir/wonokusumo
TPS 50,420,174,34,133,167,7,174,https://pilkada2015.kpu.go.id/surabayakota/semampir/wonokusumo
TPS 51,373,182,21,159,180,2,182,https://pilkada2015.kpu.go.id/surabayakota/semampir/wonokusumo
TPS 52,462,240,12,225,237,3,240,https://pilkada2015.kpu.go.id/surabayakota/semampir/wonokusumo
TPS 53,507,213,27,180,207,6,213,https://pilkada2015.kpu.go.id/surabayakota/semampir/wonokusumo
TPS 54,459,297,32,254,286,11,297,https://pilkada2015.kpu.go.id/surabayakota/semampir/wonokusumo
TPS 55,590,255,25,224,249,6,255,https://pilkada2015.kpu.go.id/surabayakota/semampir/wonokusumo
TPS 56,634,321,26,291,317,4,321,https://pilkada2015.kpu.go.id/surabayakota/semampir/wonokusumo
TPS 57,439,203,21,180,201,2,203,https://pilkada2015.kpu.go.id/surabayakota/semampir/wonokusumo
TPS 58,489,241,20,218,238,3,241,https://pilkada2015.kpu.go.id/surabayakota/semampir/wonokusumo
TPS 59,437,216,19,192,211,5,216,https://pilkada2015.kpu.go.id/surabayakota/semampir/wonokusumo
TPS 60,371,208,30,178,208,0,208,https://pilkada2015.kpu.go.id/surabayakota/semampir/wonokusumo
TPS 61,309,184,14,167,181,3,184,https://pilkada2015.kpu.go.id/surabayakota/semampir/wonokusumo
TPS 62,345,125,14,109,123,2,125,https://pilkada2015.kpu.go.id/surabayakota/semampir/wonokusumo
TPS 63,217,96,9,86,95,1,96,https://pilkada2015.kpu.go.id/surabayakota/semampir/wonokusumo
TPS 64,330,171,11,160,171,0,171,https://pilkada2015.kpu.go.id/surabayakota/semampir/wonokusumo
TPS 65,298,106,13,92,105,1,106,https://pilkada2015.kpu.go.id/surabayakota/semampir/wonokusumo
TPS 66,393,131,21,110,131,0,131,https://pilkada2015.kpu.go.id/surabayakota/semampir/wonokusumo
TPS 67,348,155,24,127,151,4,155,https://pilkada2015.kpu.go.id/surabayakota/semampir/wonokusumo
TPS 68,467,175,14,157,171,4,175,https://pilkada2015.kpu.go.id/surabayakota/semampir/wonokusumo
TPS 69,281,103,12,90,102,1,103,https://pilkada2015.kpu.go.id/surabayakota/semampir/wonokusumo
TPS 70,356,157,17,137,154,3,157,https://pilkada2015.kpu.go.id/surabayakota/semampir/wonokusumo
TPS 71,622,327,25,297,322,5,327,https://pilkada2015.kpu.go.id/surabayakota/semampir/wonokusumo
TPS 72,714,288,52,233,285,3,288,https://pilkada2015.kpu.go.id/surabayakota/semampir/wonokusumo
TPS 73,449,197,28,167,195,2,197,https://pilkada2015.kpu.go.id/surabayakota/semampir/wonokusumo
TPS 74,568,266,34,227,261,5,266,https://pilkada2015.kpu.go.id/surabayakota/semampir/wonokusumo
TPS 75,222,222,27,194,221,1,222,https://pilkada2015.kpu.go.id/surabayakota/semampir/wonokusumo
TPS 76,414,232,48,181,229,3,232,https://pilkada2015.kpu.go.id/surabayakota/semampir/wonokusumo
TPS 77,473,280,30,247,277,3,280,https://pilkada2015.kpu.go.id/surabayakota/semampir/wonokusumo
TPS 78,573,279,31,243,274,5,279,https://pilkada2015.kpu.go.id/surabayakota/semampir/wonokusumo
TPS 79,505,215,23,188,211,4,215,https://pilkada2015.kpu.go.id/surabayakota/semampir/wonokusumo
TPS 80,597,230,30,198,228,2,230,https://pilkada2015.kpu.go.id/surabayakota/semampir/wonokusumo
TPS 81,554,259,41,216,257,2,259,https://pilkada2015.kpu.go.id/surabayakota/semampir/wonokusumo
TPS 82,641,292,40,250,290,2,292,https://pilkada2015.kpu.go.id/surabayakota/semampir/wonokusumo
TPS 83,337,137,20,116,136,1,137,https://pilkada2015.kpu.go.id/surabayakota/semampir/wonokusumo
TPS 84,469,163,29,133,162,1,163,https://pilkada2015.kpu.go.id/surabayakota/semampir/wonokusumo
TPS 85,486,149,19,128,147,2,149,https://pilkada2015.kpu.go.id/surabayakota/semampir/wonokusumo
TPS 86,432,178,20,153,173,5,178,https://pilkada2015.kpu.go.id/surabayakota/semampir/wonokusumo
TPS 87,455,158,26,127,153,5,158,https://pilkada2015.kpu.go.id/surabayakota/semampir/wonokusumo
TPS 88,458,58,15,42,57,1,58,https://pilkada2015.kpu.go.id/surabayakota/semampir/wonokusumo
TPS 1,457,207,27,173,200,7,207,https://pilkada2015.kpu.go.id/surabayakota/simokerto/kapasan
TPS 2,524,231,21,206,227,4,231,https://pilkada2015.kpu.go.id/surabayakota/simokerto/kapasan
TPS 3,558,249,19,223,242,7,249,https://pilkada2015.kpu.go.id/surabayakota/simokerto/kapasan
TPS 4,445,272,42,226,268,4,272,https://pilkada2015.kpu.go.id/surabayakota/simokerto/kapasan
TPS 5,557,193,23,162,185,8,193,https://pilkada2015.kpu.go.id/surabayakota/simokerto/kapasan
TPS 6,463,210,23,186,209,1,210,https://pilkada2015.kpu.go.id/surabayakota/simokerto/kapasan
TPS 7,504,195,27,166,193,2,195,https://pilkada2015.kpu.go.id/surabayakota/simokerto/kapasan
TPS 8,541,240,8,231,239,1,240,https://pilkada2015.kpu.go.id/surabayakota/simokerto/kapasan
TPS 9,529,257,48,207,255,2,257,https://pilkada2015.kpu.go.id/surabayakota/simokerto/kapasan
TPS 10,494,229,29,191,220,9,229,https://pilkada2015.kpu.go.id/surabayakota/simokerto/kapasan
TPS 11,492,265,40,224,264,1,265,https://pilkada2015.kpu.go.id/surabayakota/simokerto/kapasan
TPS 12,495,289,33,253,286,3,289,https://pilkada2015.kpu.go.id/surabayakota/simokerto/kapasan
TPS 13,0,224,27,196,223,1,224,https://pilkada2015.kpu.go.id/surabayakota/simokerto/kapasan
TPS 14,569,256,69,182,251,5,256,https://pilkada2015.kpu.go.id/surabayakota/simokerto/kapasan
TPS 15,418,196,23,170,193,3,196,https://pilkada2015.kpu.go.id/surabayakota/simokerto/kapasan
TPS 16,503,254,42,206,248,6,254,https://pilkada2015.kpu.go.id/surabayakota/simokerto/kapasan
TPS 17,497,219,30,183,213,6,219,https://pilkada2015.kpu.go.id/surabayakota/simokerto/kapasan
TPS 18,339,166,13,149,162,4,166,https://pilkada2015.kpu.go.id/surabayakota/simokerto/kapasan
TPS 19,0,233,20,210,230,3,233,https://pilkada2015.kpu.go.id/surabayakota/simokerto/kapasan
TPS 20,572,312,47,259,306,6,312,https://pilkada2015.kpu.go.id/surabayakota/simokerto/kapasan
TPS 21,578,202,5,194,199,3,202,https://pilkada2015.kpu.go.id/surabayakota/simokerto/kapasan
TPS 22,569,251,26,222,248,3,251,https://pilkada2015.kpu.go.id/surabayakota/simokerto/kapasan
TPS 23,446,218,32,173,205,13,218,https://pilkada2015.kpu.go.id/surabayakota/simokerto/kapasan
TPS 1,523,228,23,203,226,2,228,https://pilkada2015.kpu.go.id/surabayakota/simokerto/sidodadi
TPS 2,740,258,33,223,256,2,258,https://pilkada2015.kpu.go.id/surabayakota/simokerto/sidodadi
TPS 3,631,217,27,183,210,7,217,https://pilkada2015.kpu.go.id/surabayakota/simokerto/sidodadi
TPS 4,500,188,22,163,185,3,188,https://pilkada2015.kpu.go.id/surabayakota/simokerto/sidodadi
TPS 5,597,165,13,150,163,2,165,https://pilkada2015.kpu.go.id/surabayakota/simokerto/sidodadi
TPS 6,762,331,25,303,328,3,331,https://pilkada2015.kpu.go.id/surabayakota/simokerto/sidodadi
TPS 7,755,235,32,191,223,12,235,https://pilkada2015.kpu.go.id/surabayakota/simokerto/sidodadi
TPS 8,585,204,45,154,199,5,204,https://pilkada2015.kpu.go.id/surabayakota/simokerto/sidodadi
TPS 9,511,299,19,277,296,3,299,https://pilkada2015.kpu.go.id/surabayakota/simokerto/sidodadi
TPS 10,619,215,44,165,209,6,215,https://pilkada2015.kpu.go.id/surabayakota/simokerto/sidodadi
TPS 11,289,289,58,221,279,10,289,https://pilkada2015.kpu.go.id/surabayakota/simokerto/sidodadi
TPS 12,0,209,18,186,204,5,209,https://pilkada2015.kpu.go.id/surabayakota/simokerto/sidodadi
TPS 13,305,104,6,98,104,0,104,https://pilkada2015.kpu.go.id/surabayakota/simokerto/sidodadi
TPS 14,491,213,32,178,210,3,213,https://pilkada2015.kpu.go.id/surabayakota/simokerto/sidodadi
TPS 15,366,113,20,91,111,2,113,https://pilkada2015.kpu.go.id/surabayakota/simokerto/sidodadi
TPS 16,651,287,34,251,285,2,287,https://pilkada2015.kpu.go.id/surabayakota/simokerto/sidodadi
TPS 17,336,151,19,129,148,3,151,https://pilkada2015.kpu.go.id/surabayakota/simokerto/sidodadi
TPS 18,427,188,17,167,184,4,188,https://pilkada2015.kpu.go.id/surabayakota/simokerto/sidodadi
TPS 19,359,123,29,92,0,0,0,https://pilkada2015.kpu.go.id/surabayakota/simokerto/sidodadi
TPS 20,517,183,22,157,179,4,183,https://pilkada2015.kpu.go.id/surabayakota/simokerto/sidodadi
TPS 21,691,223,34,181,215,8,223,https://pilkada2015.kpu.go.id/surabayakota/simokerto/sidodadi
TPS 22,769,285,35,247,282,3,285,https://pilkada2015.kpu.go.id/surabayakota/simokerto/sidodadi
TPS 23,775,221,55,161,216,5,221,https://pilkada2015.kpu.go.id/surabayakota/simokerto/sidodadi
TPS 24,636,180,30,147,177,3,180,https://pilkada2015.kpu.go.id/surabayakota/simokerto/sidodadi
TPS 1,627,377,37,334,371,6,377,https://pilkada2015.kpu.go.id/surabayakota/simokerto/simokerto
TPS 2,647,257,31,222,253,4,257,https://pilkada2015.kpu.go.id/surabayakota/simokerto/simokerto
TPS 3,643,304,35,262,297,7,304,https://pilkada2015.kpu.go.id/surabayakota/simokerto/simokerto
TPS 4,627,323,51,270,321,2,323,https://pilkada2015.kpu.go.id/surabayakota/simokerto/simokerto
TPS 5,621,315,33,267,300,15,315,https://pilkada2015.kpu.go.id/surabayakota/simokerto/simokerto
TPS 6,251,164,17,143,160,4,164,https://pilkada2015.kpu.go.id/surabayakota/simokerto/simokerto
TPS 7,312,171,27,142,169,2,171,https://pilkada2015.kpu.go.id/surabayakota/simokerto/simokerto
TPS 8,446,206,31,168,199,7,206,https://pilkada2015.kpu.go.id/surabayakota/simokerto/simokerto
TPS 9,554,235,23,205,228,7,235,https://pilkada2015.kpu.go.id/surabayakota/simokerto/simokerto
TPS 10,492,248,29,217,246,2,248,https://pilkada2015.kpu.go.id/surabayakota/simokerto/simokerto
TPS 11,353,99,7,91,98,1,99,https://pilkada2015.kpu.go.id/surabayakota/simokerto/simokerto
TPS 12,665,351,32,312,344,7,351,https://pilkada2015.kpu.go.id/surabayakota/simokerto/simokerto
TPS 13,553,279,25,250,275,4,279,https://pilkada2015.kpu.go.id/surabayakota/simokerto/simokerto
TPS 14,390,240,18,220,238,2,240,https://pilkada2015.kpu.go.id/surabayakota/simokerto/simokerto
TPS 15,462,164,29,134,163,1,164,https://pilkada2015.kpu.go.id/surabayakota/simokerto/simokerto
TPS 16,718,396,38,354,392,4,396,https://pilkada2015.kpu.go.id/surabayakota/simokerto/simokerto
TPS 17,753,371,32,337,369,2,371,https://pilkada2015.kpu.go.id/surabayakota/simokerto/simokerto
TPS 18,371,240,22,215,237,3,240,https://pilkada2015.kpu.go.id/surabayakota/simokerto/simokerto
TPS 19,270,123,19,101,120,3,123,https://pilkada2015.kpu.go.id/surabayakota/simokerto/simokerto
TPS 20,514,262,23,234,257,5,262,https://pilkada2015.kpu.go.id/surabayakota/simokerto/simokerto
TPS 21,560,294,42,246,288,6,294,https://pilkada2015.kpu.go.id/surabayakota/simokerto/simokerto
TPS 22,576,202,17,183,200,2,202,https://pilkada2015.kpu.go.id/surabayakota/simokerto/simokerto
TPS 23,681,285,15,267,282,3,285,https://pilkada2015.kpu.go.id/surabayakota/simokerto/simokerto
TPS 24,573,259,15,243,258,1,259,https://pilkada2015.kpu.go.id/surabayakota/simokerto/simokerto
TPS 25,469,209,31,176,207,2,209,https://pilkada2015.kpu.go.id/surabayakota/simokerto/simokerto
TPS 26,326,194,22,170,192,2,194,https://pilkada2015.kpu.go.id/surabayakota/simokerto/simokerto
TPS 27,339,197,22,169,191,6,197,https://pilkada2015.kpu.go.id/surabayakota/simokerto/simokerto
TPS 28,372,221,47,167,214,7,221,https://pilkada2015.kpu.go.id/surabayakota/simokerto/simokerto
TPS 29,422,221,17,194,211,10,221,https://pilkada2015.kpu.go.id/surabayakota/simokerto/simokerto
TPS 30,754,405,44,359,403,2,405,https://pilkada2015.kpu.go.id/surabayakota/simokerto/simokerto
TPS 31,759,254,18,233,251,3,254,https://pilkada2015.kpu.go.id/surabayakota/simokerto/simokerto
TPS 1,614,326,43,279,322,4,326,https://pilkada2015.kpu.go.id/surabayakota/simokerto/simolawang
TPS 2,459,164,17,146,0,0,0,https://pilkada2015.kpu.go.id/surabayakota/simokerto/simolawang
TPS 3,344,164,14,140,154,10,164,https://pilkada2015.kpu.go.id/surabayakota/simokerto/simolawang
TPS 4,413,278,97,174,271,7,278,https://pilkada2015.kpu.go.id/surabayakota/simokerto/simolawang
TPS 5,633,314,74,231,335,9,314,https://pilkada2015.kpu.go.id/surabayakota/simokerto/simolawang
TPS 6,580,282,43,232,275,7,282,https://pilkada2015.kpu.go.id/surabayakota/simokerto/simolawang
TPS 7,418,196,32,158,190,6,196,https://pilkada2015.kpu.go.id/surabayakota/simokerto/simolawang
TPS 8,539,256,38,209,247,4,251,https://pilkada2015.kpu.go.id/surabayakota/simokerto/simolawang
TPS 9,547,235,39,187,226,9,235,https://pilkada2015.kpu.go.id/surabayakota/simokerto/simolawang
TPS 10,582,249,48,193,241,8,249,https://pilkada2015.kpu.go.id/surabayakota/simokerto/simolawang
TPS 11,535,223,47,165,212,11,223,https://pilkada2015.kpu.go.id/surabayakota/simokerto/simolawang
TPS 12,438,125,14,108,122,3,125,https://pilkada2015.kpu.go.id/surabayakota/simokerto/simolawang
TPS 13,572,216,39,175,214,2,216,https://pilkada2015.kpu.go.id/surabayakota/simokerto/simolawang
TPS 14,496,212,74,137,211,1,212,https://pilkada2015.kpu.go.id/surabayakota/simokerto/simolawang
TPS 15,287,177,24,149,173,4,177,https://pilkada2015.kpu.go.id/surabayakota/simokerto/simolawang
TPS 16,312,207,23,175,198,9,207,https://pilkada2015.kpu.go.id/surabayakota/simokerto/simolawang
TPS 17,537,222,29,132,221,1,222,https://pilkada2015.kpu.go.id/surabayakota/simokerto/simolawang
TPS 18,398,280,42,229,271,9,280,https://pilkada2015.kpu.go.id/surabayakota/simokerto/simolawang
TPS 19,483,282,41,234,275,7,282,https://pilkada2015.kpu.go.id/surabayakota/simokerto/simolawang
TPS 20,384,233,28,204,232,1,233,https://pilkada2015.kpu.go.id/surabayakota/simokerto/simolawang
TPS 21,458,191,39,149,188,3,191,https://pilkada2015.kpu.go.id/surabayakota/simokerto/simolawang
TPS 22,126,126,22,99,121,5,126,https://pilkada2015.kpu.go.id/surabayakota/simokerto/simolawang
TPS 23,382,192,36,149,185,7,192,https://pilkada2015.kpu.go.id/surabayakota/simokerto/simolawang
TPS 24,433,156,33,121,154,2,156,https://pilkada2015.kpu.go.id/surabayakota/simokerto/simolawang
TPS 25,519,0,57,214,271,8,279,https://pilkada2015.kpu.go.id/surabayakota/simokerto/simolawang
TPS 26,478,179,33,142,175,4,179,https://pilkada2015.kpu.go.id/surabayakota/simokerto/simolawang
TPS 27,576,239,78,153,231,8,239,https://pilkada2015.kpu.go.id/surabayakota/simokerto/simolawang
TPS 28,505,159,26,132,158,1,159,https://pilkada2015.kpu.go.id/surabayakota/simokerto/simolawang
TPS 29,211,208,27,177,204,4,208,https://pilkada2015.kpu.go.id/surabayakota/simokerto/simolawang
TPS 30,344,184,23,160,183,1,184,https://pilkada2015.kpu.go.id/surabayakota/simokerto/simolawang
TPS 31,413,205,12,192,204,1,205,https://pilkada2015.kpu.go.id/surabayakota/simokerto/simolawang
TPS 1,750,277,43,229,272,5,277,https://pilkada2015.kpu.go.id/surabayakota/simokerto/tambakrejo
TPS 2,584,247,53,190,243,4,247,https://pilkada2015.kpu.go.id/surabayakota/simokerto/tambakrejo
TPS 3,780,378,35,338,373,5,378,https://pilkada2015.kpu.go.id/surabayakota/simokerto/tambakrejo
TPS 4,700,278,71,202,273,5,278,https://pilkada2015.kpu.go.id/surabayakota/simokerto/tambakrejo
TPS 5,585,280,43,233,276,4,280,https://pilkada2015.kpu.go.id/surabayakota/simokerto/tambakrejo
TPS 6,386,185,23,155,178,7,185,https://pilkada2015.kpu.go.id/surabayakota/simokerto/tambakrejo
TPS 7,561,234,31,199,230,4,234,https://pilkada2015.kpu.go.id/surabayakota/simokerto/tambakrejo
TPS 8,627,298,0,0,287,11,298,https://pilkada2015.kpu.go.id/surabayakota/simokerto/tambakrejo
TPS 9,375,196,28,161,189,7,196,https://pilkada2015.kpu.go.id/surabayakota/simokerto/tambakrejo
TPS 10,565,327,68,253,321,6,327,https://pilkada2015.kpu.go.id/surabayakota/simokerto/tambakrejo
TPS 11,491,197,22,163,185,12,197,https://pilkada2015.kpu.go.id/surabayakota/simokerto/tambakrejo
TPS 12,469,220,53,166,219,1,220,https://pilkada2015.kpu.go.id/surabayakota/simokerto/tambakrejo
TPS 13,467,223,36,182,218,5,223,https://pilkada2015.kpu.go.id/surabayakota/simokerto/tambakrejo
TPS 14,559,263,19,241,260,3,263,https://pilkada2015.kpu.go.id/surabayakota/simokerto/tambakrejo
TPS 15,515,252,27,225,252,0,252,https://pilkada2015.kpu.go.id/surabayakota/simokerto/tambakrejo
TPS 16,165,166,19,142,161,5,166,https://pilkada2015.kpu.go.id/surabayakota/simokerto/tambakrejo
TPS 17,436,271,31,235,266,5,271,https://pilkada2015.kpu.go.id/surabayakota/simokerto/tambakrejo
TPS 18,495,280,31,240,271,9,280,https://pilkada2015.kpu.go.id/surabayakota/simokerto/tambakrejo
TPS 19,503,237,36,195,231,6,237,https://pilkada2015.kpu.go.id/surabayakota/simokerto/tambakrejo
TPS 20,542,210,28,177,205,5,210,https://pilkada2015.kpu.go.id/surabayakota/simokerto/tambakrejo
TPS 21,435,210,29,179,208,2,210,https://pilkada2015.kpu.go.id/surabayakota/simokerto/tambakrejo
TPS 22,467,298,0,0,291,7,298,https://pilkada2015.kpu.go.id/surabayakota/simokerto/tambakrejo
TPS 23,440,268,28,236,264,4,268,https://pilkada2015.kpu.go.id/surabayakota/simokerto/tambakrejo
TPS 24,508,222,33,187,220,2,222,https://pilkada2015.kpu.go.id/surabayakota/simokerto/tambakrejo
TPS 25,499,258,46,208,254,4,258,https://pilkada2015.kpu.go.id/surabayakota/simokerto/tambakrejo
TPS 26,507,291,30,255,285,6,291,https://pilkada2015.kpu.go.id/surabayakota/simokerto/tambakrejo
TPS 27,580,324,56,262,318,6,324,https://pilkada2015.kpu.go.id/surabayakota/simokerto/tambakrejo
TPS 28,490,268,38,228,266,2,268,https://pilkada2015.kpu.go.id/surabayakota/simokerto/tambakrejo
TPS 1,635,377,52,313,365,12,377,https://pilkada2015.kpu.go.id/surabayakota/sukolilo/gebang_putih
TPS 2,676,383,57,317,374,9,383,https://pilkada2015.kpu.go.id/surabayakota/sukolilo/gebang_putih
TPS 3,614,338,60,263,323,15,338,https://pilkada2015.kpu.go.id/surabayakota/sukolilo/gebang_putih
TPS 4,461,249,44,200,244,5,249,https://pilkada2015.kpu.go.id/surabayakota/sukolilo/gebang_putih
TPS 5,516,307,42,258,300,7,307,https://pilkada2015.kpu.go.id/surabayakota/sukolilo/gebang_putih
TPS 6,442,244,26,217,243,1,244,https://pilkada2015.kpu.go.id/surabayakota/sukolilo/gebang_putih
TPS 7,434,221,38,183,221,0,221,https://pilkada2015.kpu.go.id/surabayakota/sukolilo/gebang_putih
TPS 8,402,141,14,126,140,1,141,https://pilkada2015.kpu.go.id/surabayakota/sukolilo/gebang_putih
TPS 9,465,230,18,211,229,1,230,https://pilkada2015.kpu.go.id/surabayakota/sukolilo/gebang_putih
TPS 10,415,153,12,140,152,1,153,https://pilkada2015.kpu.go.id/surabayakota/sukolilo/gebang_putih
TPS 1,247,247,18,229,247,0,247,https://pilkada2015.kpu.go.id/surabayakota/sukolilo/keputih
TPS 2,577,289,27,258,285,4,289,https://pilkada2015.kpu.go.id/surabayakota/sukolilo/keputih
TPS 3,353,186,25,157,182,4,186,https://pilkada2015.kpu.go.id/surabayakota/sukolilo/keputih
TPS 4,469,273,23,246,269,4,273,https://pilkada2015.kpu.go.id/surabayakota/sukolilo/keputih
TPS 5,714,252,59,192,251,1,252,https://pilkada2015.kpu.go.id/surabayakota/sukolilo/keputih
TPS 6,583,301,38,259,297,4,301,https://pilkada2015.kpu.go.id/surabayakota/sukolilo/keputih
TPS 7,518,322,58,257,315,2,317,https://pilkada2015.kpu.go.id/surabayakota/sukolilo/keputih
TPS 8,257,138,65,70,135,3,138,https://pilkada2015.kpu.go.id/surabayakota/sukolilo/keputih
TPS 9,405,269,156,95,251,18,269,https://pilkada2015.kpu.go.id/surabayakota/sukolilo/keputih
TPS 10,618,275,33,241,274,1,275,https://pilkada2015.kpu.go.id/surabayakota/sukolilo/keputih
TPS 11,532,242,22,220,242,0,242,https://pilkada2015.kpu.go.id/surabayakota/sukolilo/keputih
TPS 12,690,312,36,268,304,8,312,https://pilkada2015.kpu.go.id/surabayakota/sukolilo/keputih
TPS 13,445,245,33,206,239,6,245,https://pilkada2015.kpu.go.id/surabayakota/sukolilo/keputih
TPS 14,0,0,43,211,254,0,254,https://pilkada2015.kpu.go.id/surabayakota/sukolilo/keputih
TPS 15,614,361,48,311,359,2,361,https://pilkada2015.kpu.go.id/surabayakota/sukolilo/keputih
TPS 16,754,506,57,441,498,8,506,https://pilkada2015.kpu.go.id/surabayakota/sukolilo/keputih
TPS 17,573,356,45,305,350,6,356,https://pilkada2015.kpu.go.id/surabayakota/sukolilo/keputih
TPS 18,653,297,29,267,296,1,297,https://pilkada2015.kpu.go.id/surabayakota/sukolilo/keputih
TPS 19,371,221,26,189,215,6,221,https://pilkada2015.kpu.go.id/surabayakota/sukolilo/keputih
TPS 1,603,311,33,277,310,1,311,https://pilkada2015.kpu.go.id/surabayakota/sukolilo/klampis_ngasem
TPS 2,524,319,17,296,313,6,319,https://pilkada2015.kpu.go.id/surabayakota/sukolilo/klampis_ngasem
TPS 3,564,262,22,237,259,3,262,https://pilkada2015.kpu.go.id/surabayakota/sukolilo/klampis_ngasem
TPS 4,635,391,47,333,380,11,391,https://pilkada2015.kpu.go.id/surabayakota/sukolilo/klampis_ngasem
TPS 5,548,347,35,307,342,5,347,https://pilkada2015.kpu.go.id/surabayakota/sukolilo/klampis_ngasem
TPS 6,524,240,25,210,235,5,240,https://pilkada2015.kpu.go.id/surabayakota/sukolilo/klampis_ngasem
TPS 7,731,392,29,363,392,0,392,https://pilkada2015.kpu.go.id/surabayakota/sukolilo/klampis_ngasem
TPS 8,492,299,24,273,297,2,299,https://pilkada2015.kpu.go.id/surabayakota/sukolilo/klampis_ngasem
TPS 9,458,230,18,209,227,3,230,https://pilkada2015.kpu.go.id/surabayakota/sukolilo/klampis_ngasem
TPS 10,615,396,32,358,390,6,396,https://pilkada2015.kpu.go.id/surabayakota/sukolilo/klampis_ngasem
TPS 11,456,245,18,226,244,1,245,https://pilkada2015.kpu.go.id/surabayakota/sukolilo/klampis_ngasem
TPS 12,410,207,20,186,206,1,207,https://pilkada2015.kpu.go.id/surabayakota/sukolilo/klampis_ngasem
TPS 13,473,205,16,188,204,1,205,https://pilkada2015.kpu.go.id/surabayakota/sukolilo/klampis_ngasem
TPS 14,523,259,23,235,258,1,259,https://pilkada2015.kpu.go.id/surabayakota/sukolilo/klampis_ngasem
TPS 15,489,260,17,242,259,1,260,https://pilkada2015.kpu.go.id/surabayakota/sukolilo/klampis_ngasem
TPS 16,492,260,14,246,260,0,260,https://pilkada2015.kpu.go.id/surabayakota/sukolilo/klampis_ngasem
TPS 17,493,229,13,215,228,1,229,https://pilkada2015.kpu.go.id/surabayakota/sukolilo/klampis_ngasem
TPS 18,715,369,52,309,361,8,369,https://pilkada2015.kpu.go.id/surabayakota/sukolilo/klampis_ngasem
TPS 19,657,364,63,289,352,12,364,https://pilkada2015.kpu.go.id/surabayakota/sukolilo/klampis_ngasem
TPS 20,406,252,18,232,250,2,252,https://pilkada2015.kpu.go.id/surabayakota/sukolilo/klampis_ngasem
TPS 21,377,145,7,134,141,4,145,https://pilkada2015.kpu.go.id/surabayakota/sukolilo/klampis_ngasem
TPS 22,414,183,13,166,179,4,183,https://pilkada2015.kpu.go.id/surabayakota/sukolilo/klampis_ngasem
TPS 23,500,241,17,223,240,1,241,https://pilkada2015.kpu.go.id/surabayakota/sukolilo/klampis_ngasem
TPS 1,636,358,36,314,350,8,358,https://pilkada2015.kpu.go.id/surabayakota/sukolilo/medokan_semampir
TPS 2,582,229,27,198,225,4,229,https://pilkada2015.kpu.go.id/surabayakota/sukolilo/medokan_semampir
TPS 3,675,347,45,299,344,3,347,https://pilkada2015.kpu.go.id/surabayakota/sukolilo/medokan_semampir
TPS 4,658,351,56,286,342,9,351,https://pilkada2015.kpu.go.id/surabayakota/sukolilo/medokan_semampir
TPS 5,570,374,55,303,358,16,374,https://pilkada2015.kpu.go.id/surabayakota/sukolilo/medokan_semampir
TPS 6,617,232,41,188,229,3,232,https://pilkada2015.kpu.go.id/surabayakota/sukolilo/medokan_semampir
TPS 7,501,279,68,205,273,6,279,https://pilkada2015.kpu.go.id/surabayakota/sukolilo/medokan_semampir
TPS 8,548,379,39,329,368,11,379,https://pilkada2015.kpu.go.id/surabayakota/sukolilo/medokan_semampir
TPS 9,495,265,38,227,265,0,265,https://pilkada2015.kpu.go.id/surabayakota/sukolilo/medokan_semampir
TPS 10,549,254,35,215,250,4,254,https://pilkada2015.kpu.go.id/surabayakota/sukolilo/medokan_semampir
TPS 11,627,207,29,174,203,4,207,https://pilkada2015.kpu.go.id/surabayakota/sukolilo/medokan_semampir
TPS 12,373,246,20,225,245,1,246,https://pilkada2015.kpu.go.id/surabayakota/sukolilo/medokan_semampir
TPS 13,487,263,38,219,257,6,263,https://pilkada2015.kpu.go.id/surabayakota/sukolilo/medokan_semampir
TPS 14,438,263,26,228,254,9,263,https://pilkada2015.kpu.go.id/surabayakota/sukolilo/medokan_semampir
TPS 15,534,264,37,223,260,4,264,https://pilkada2015.kpu.go.id/surabayakota/sukolilo/medokan_semampir
TPS 16,528,273,32,238,270,3,273,https://pilkada2015.kpu.go.id/surabayakota/sukolilo/medokan_semampir
TPS 17,542,298,39,258,297,1,298,https://pilkada2015.kpu.go.id/surabayakota/sukolilo/medokan_semampir
TPS 18,534,246,60,178,238,8,246,https://pilkada2015.kpu.go.id/surabayakota/sukolilo/medokan_semampir
TPS 19,654,376,93,270,363,13,376,https://pilkada2015.kpu.go.id/surabayakota/sukolilo/medokan_semampir
TPS 20,647,292,43,243,286,6,292,https://pilkada2015.kpu.go.id/surabayakota/sukolilo/medokan_semampir
TPS 21,636,322,35,280,315,7,322,https://pilkada2015.kpu.go.id/surabayakota/sukolilo/medokan_semampir
TPS 22,368,137,16,121,137,0,137,https://pilkada2015.kpu.go.id/surabayakota/sukolilo/medokan_semampir
TPS 23,131,131,6,125,131,0,131,https://pilkada2015.kpu.go.id/surabayakota/sukolilo/medokan_semampir
TPS 1,605,312,58,251,309,3,312,https://pilkada2015.kpu.go.id/surabayakota/sukolilo/menur_pumpungan
TPS 2,590,298,48,245,293,5,298,https://pilkada2015.kpu.go.id/surabayakota/sukolilo/menur_pumpungan
TPS 3,690,369,53,310,363,6,369,https://pilkada2015.kpu.go.id/surabayakota/sukolilo/menur_pumpungan
TPS 4,407,242,58,182,240,2,242,https://pilkada2015.kpu.go.id/surabayakota/sukolilo/menur_pumpungan
TPS 5,668,352,27,319,346,6,352,https://pilkada2015.kpu.go.id/surabayakota/sukolilo/menur_pumpungan
TPS 6,361,198,9,189,198,0,198,https://pilkada2015.kpu.go.id/surabayakota/sukolilo/menur_pumpungan
TPS 7,492,267,25,238,263,4,267,https://pilkada2015.kpu.go.id/surabayakota/sukolilo/menur_pumpungan
TPS 8,584,315,44,262,306,9,315,https://pilkada2015.kpu.go.id/surabayakota/sukolilo/menur_pumpungan
TPS 9,617,263,19,242,261,2,263,https://pilkada2015.kpu.go.id/surabayakota/sukolilo/menur_pumpungan
TPS 10,437,174,10,163,173,1,174,https://pilkada2015.kpu.go.id/surabayakota/sukolilo/menur_pumpungan
TPS 11,359,183,20,161,181,2,183,https://pilkada2015.kpu.go.id/surabayakota/sukolilo/menur_pumpungan
TPS 12,397,201,11,188,199,2,201,https://pilkada2015.kpu.go.id/surabayakota/sukolilo/menur_pumpungan
TPS 13,580,336,35,293,328,8,336,https://pilkada2015.kpu.go.id/surabayakota/sukolilo/menur_pumpungan
TPS 14,719,331,32,296,328,3,331,https://pilkada2015.kpu.go.id/surabayakota/sukolilo/menur_pumpungan
TPS 15,190,190,19,170,189,1,190,https://pilkada2015.kpu.go.id/surabayakota/sukolilo/menur_pumpungan
TPS 16,511,205,8,197,205,0,205,https://pilkada2015.kpu.go.id/surabayakota/sukolilo/menur_pumpungan
TPS 17,543,216,23,192,215,1,216,https://pilkada2015.kpu.go.id/surabayakota/sukolilo/menur_pumpungan
TPS 18,453,205,25,178,203,2,205,https://pilkada2015.kpu.go.id/surabayakota/sukolilo/menur_pumpungan
TPS 19,448,250,46,201,247,3,250,https://pilkada2015.kpu.go.id/surabayakota/sukolilo/menur_pumpungan
TPS 20,301,157,13,143,156,1,157,https://pilkada2015.kpu.go.id/surabayakota/sukolilo/menur_pumpungan
TPS 21,508,268,41,225,266,2,268,https://pilkada2015.kpu.go.id/surabayakota/sukolilo/menur_pumpungan
TPS 22,430,225,32,186,218,7,225,https://pilkada2015.kpu.go.id/surabayakota/sukolilo/menur_pumpungan
TPS 23,536,322,38,274,312,10,322,https://pilkada2015.kpu.go.id/surabayakota/sukolilo/menur_pumpungan
TPS 1,525,315,40,264,304,11,315,https://pilkada2015.kpu.go.id/surabayakota/sukolilo/nginden_jangkungan
TPS 2,464,233,20,208,228,5,233,https://pilkada2015.kpu.go.id/surabayakota/sukolilo/nginden_jangkungan
TPS 3,448,248,40,205,245,3,248,https://pilkada2015.kpu.go.id/surabayakota/sukolilo/nginden_jangkungan
TPS 4,361,206,21,175,196,10,206,https://pilkada2015.kpu.go.id/surabayakota/sukolilo/nginden_jangkungan
TPS 5,317,145,23,118,141,4,145,https://pilkada2015.kpu.go.id/surabayakota/sukolilo/nginden_jangkungan
TPS 6,468,288,31,253,284,4,288,https://pilkada2015.kpu.go.id/surabayakota/sukolilo/nginden_jangkungan
TPS 7,542,290,28,259,287,3,290,https://pilkada2015.kpu.go.id/surabayakota/sukolilo/nginden_jangkungan
TPS 8,435,233,38,192,230,3,233,https://pilkada2015.kpu.go.id/surabayakota/sukolilo/nginden_jangkungan
TPS 9,442,299,31,266,297,2,299,https://pilkada2015.kpu.go.id/surabayakota/sukolilo/nginden_jangkungan
TPS 10,423,278,15,259,274,4,278,https://pilkada2015.kpu.go.id/surabayakota/sukolilo/nginden_jangkungan
TPS 11,662,375,31,334,365,10,375,https://pilkada2015.kpu.go.id/surabayakota/sukolilo/nginden_jangkungan
TPS 12,350,226,28,197,225,1,226,https://pilkada2015.kpu.go.id/surabayakota/sukolilo/nginden_jangkungan
TPS 13,564,294,51,242,293,1,294,https://pilkada2015.kpu.go.id/surabayakota/sukolilo/nginden_jangkungan
TPS 14,564,335,51,275,326,9,335,https://pilkada2015.kpu.go.id/surabayakota/sukolilo/nginden_jangkungan
TPS 15,406,254,23,228,251,3,254,https://pilkada2015.kpu.go.id/surabayakota/sukolilo/nginden_jangkungan
TPS 16,543,279,39,236,275,4,279,https://pilkada2015.kpu.go.id/surabayakota/sukolilo/nginden_jangkungan
TPS 17,661,306,22,277,299,7,306,https://pilkada2015.kpu.go.id/surabayakota/sukolilo/nginden_jangkungan
TPS 18,550,261,34,226,260,1,261,https://pilkada2015.kpu.go.id/surabayakota/sukolilo/nginden_jangkungan
TPS 19,603,291,21,266,287,4,291,https://pilkada2015.kpu.go.id/surabayakota/sukolilo/nginden_jangkungan
TPS 20,606,352,39,306,0,0,0,https://pilkada2015.kpu.go.id/surabayakota/sukolilo/nginden_jangkungan
TPS 1,657,341,25,311,336,5,341,https://pilkada2015.kpu.go.id/surabayakota/sukolilo/semolowaru
TPS 2,468,310,0,0,0,0,0,https://pilkada2015.kpu.go.id/surabayakota/sukolilo/semolowaru
TPS 3,526,255,45,204,249,6,255,https://pilkada2015.kpu.go.id/surabayakota/sukolilo/semolowaru
TPS 4,518,253,35,212,247,6,253,https://pilkada2015.kpu.go.id/surabayakota/sukolilo/semolowaru
TPS 5,620,320,68,251,319,1,320,https://pilkada2015.kpu.go.id/surabayakota/sukolilo/semolowaru
TPS 6,630,255,13,242,255,0,255,https://pilkada2015.kpu.go.id/surabayakota/sukolilo/semolowaru
TPS 7,779,282,17,262,279,3,282,https://pilkada2015.kpu.go.id/surabayakota/sukolilo/semolowaru
TPS 8,625,187,9,178,187,0,187,https://pilkada2015.kpu.go.id/surabayakota/sukolilo/semolowaru
TPS 9,450,249,29,217,246,3,249,https://pilkada2015.kpu.go.id/surabayakota/sukolilo/semolowaru
TPS 10,628,407,50,352,402,5,407,https://pilkada2015.kpu.go.id/surabayakota/sukolilo/semolowaru
TPS 11,634,357,47,308,355,2,357,https://pilkada2015.kpu.go.id/surabayakota/sukolilo/semolowaru
TPS 12,495,266,43,220,263,3,266,https://pilkada2015.kpu.go.id/surabayakota/sukolilo/semolowaru
TPS 13,459,256,28,226,254,2,256,https://pilkada2015.kpu.go.id/surabayakota/sukolilo/semolowaru
TPS 14,482,228,27,201,228,0,228,https://pilkada2015.kpu.go.id/surabayakota/sukolilo/semolowaru
TPS 15,433,257,17,237,256,1,257,https://pilkada2015.kpu.go.id/surabayakota/sukolilo/semolowaru
TPS 16,436,221,19,199,218,3,221,https://pilkada2015.kpu.go.id/surabayakota/sukolilo/semolowaru
TPS 17,467,230,34,192,226,4,230,https://pilkada2015.kpu.go.id/surabayakota/sukolilo/semolowaru
TPS 18,501,277,42,234,276,1,277,https://pilkada2015.kpu.go.id/surabayakota/sukolilo/semolowaru
TPS 19,558,284,44,234,278,6,284,https://pilkada2015.kpu.go.id/surabayakota/sukolilo/semolowaru
TPS 20,499,216,35,177,212,4,216,https://pilkada2015.kpu.go.id/surabayakota/sukolilo/semolowaru
TPS 21,475,274,35,236,0,0,0,https://pilkada2015.kpu.go.id/surabayakota/sukolilo/semolowaru
TPS 22,540,299,46,247,293,6,299,https://pilkada2015.kpu.go.id/surabayakota/sukolilo/semolowaru
TPS 23,497,247,87,158,245,2,247,https://pilkada2015.kpu.go.id/surabayakota/sukolilo/semolowaru
TPS 24,657,320,66,247,313,7,320,https://pilkada2015.kpu.go.id/surabayakota/sukolilo/semolowaru
TPS 25,658,349,60,284,344,5,349,https://pilkada2015.kpu.go.id/surabayakota/sukolilo/semolowaru
TPS 26,460,205,23,181,204,1,205,https://pilkada2015.kpu.go.id/surabayakota/sukolilo/semolowaru
TPS 1,475,285,37,242,279,6,285,https://pilkada2015.kpu.go.id/surabayakota/sukomanunggal/putat_gede
TPS 2,482,241,39,200,239,2,241,https://pilkada2015.kpu.go.id/surabayakota/sukomanunggal/putat_gede
TPS 3,467,256,32,221,253,3,256,https://pilkada2015.kpu.go.id/surabayakota/sukomanunggal/putat_gede
TPS 4,410,194,29,160,189,5,194,https://pilkada2015.kpu.go.id/surabayakota/sukomanunggal/putat_gede
TPS 5,370,241,30,205,235,6,241,https://pilkada2015.kpu.go.id/surabayakota/sukomanunggal/putat_gede
TPS 6,341,231,26,199,225,6,231,https://pilkada2015.kpu.go.id/surabayakota/sukomanunggal/putat_gede
TPS 7,476,233,13,216,229,4,233,https://pilkada2015.kpu.go.id/surabayakota/sukomanunggal/putat_gede
TPS 8,354,189,24,155,179,10,189,https://pilkada2015.kpu.go.id/surabayakota/sukomanunggal/putat_gede
TPS 9,384,250,22,226,248,2,250,https://pilkada2015.kpu.go.id/surabayakota/sukomanunggal/putat_gede
TPS 10,458,226,29,192,221,5,226,https://pilkada2015.kpu.go.id/surabayakota/sukomanunggal/putat_gede
TPS 1,493,259,34,218,252,7,259,https://pilkada2015.kpu.go.id/surabayakota/sukomanunggal/simomulyo
TPS 2,465,292,28,256,284,8,292,https://pilkada2015.kpu.go.id/surabayakota/sukomanunggal/simomulyo
TPS 3,508,299,29,264,293,6,299,https://pilkada2015.kpu.go.id/surabayakota/sukomanunggal/simomulyo
TPS 4,592,305,42,261,303,2,305,https://pilkada2015.kpu.go.id/surabayakota/sukomanunggal/simomulyo
TPS 5,407,222,28,189,217,5,222,https://pilkada2015.kpu.go.id/surabayakota/sukomanunggal/simomulyo
TPS 6,403,241,36,197,233,8,241,https://pilkada2015.kpu.go.id/surabayakota/sukomanunggal/simomulyo
TPS 7,370,201,30,164,194,7,201,https://pilkada2015.kpu.go.id/surabayakota/sukomanunggal/simomulyo
TPS 8,434,273,48,224,272,1,273,https://pilkada2015.kpu.go.id/surabayakota/sukomanunggal/simomulyo
TPS 9,449,286,34,248,282,4,286,https://pilkada2015.kpu.go.id/surabayakota/sukomanunggal/simomulyo
TPS 10,575,352,39,312,351,1,352,https://pilkada2015.kpu.go.id/surabayakota/sukomanunggal/simomulyo
TPS 11,211,211,45,164,209,2,211,https://pilkada2015.kpu.go.id/surabayakota/sukomanunggal/simomulyo
TPS 12,360,171,17,151,168,3,171,https://pilkada2015.kpu.go.id/surabayakota/sukomanunggal/simomulyo
TPS 13,470,250,32,215,247,3,250,https://pilkada2015.kpu.go.id/surabayakota/sukomanunggal/simomulyo
TPS 14,527,296,32,261,293,3,296,https://pilkada2015.kpu.go.id/surabayakota/sukomanunggal/simomulyo
TPS 15,514,327,51,267,318,9,327,https://pilkada2015.kpu.go.id/surabayakota/sukomanunggal/simomulyo
TPS 16,526,345,35,305,340,2,342,https://pilkada2015.kpu.go.id/surabayakota/sukomanunggal/simomulyo
TPS 17,589,338,36,294,330,8,338,https://pilkada2015.kpu.go.id/surabayakota/sukomanunggal/simomulyo
TPS 18,520,271,17,250,267,4,271,https://pilkada2015.kpu.go.id/surabayakota/sukomanunggal/simomulyo
TPS 19,427,254,26,227,253,1,254,https://pilkada2015.kpu.go.id/surabayakota/sukomanunggal/simomulyo
TPS 20,509,266,23,236,259,7,266,https://pilkada2015.kpu.go.id/surabayakota/sukomanunggal/simomulyo
TPS 21,653,402,34,364,398,4,402,https://pilkada2015.kpu.go.id/surabayakota/sukomanunggal/simomulyo
TPS 22,614,275,29,268,268,7,275,https://pilkada2015.kpu.go.id/surabayakota/sukomanunggal/simomulyo
TPS 23,502,274,26,244,270,4,274,https://pilkada2015.kpu.go.id/surabayakota/sukomanunggal/simomulyo
TPS 24,575,321,31,288,319,2,321,https://pilkada2015.kpu.go.id/surabayakota/sukomanunggal/simomulyo
TPS 25,519,316,54,255,309,7,316,https://pilkada2015.kpu.go.id/surabayakota/sukomanunggal/simomulyo
TPS 26,505,365,52,300,352,13,365,https://pilkada2015.kpu.go.id/surabayakota/sukomanunggal/simomulyo
TPS 27,550,290,27,259,286,4,290,https://pilkada2015.kpu.go.id/surabayakota/sukomanunggal/simomulyo
TPS 28,514,276,60,214,274,2,276,https://pilkada2015.kpu.go.id/surabayakota/sukomanunggal/simomulyo
TPS 29,611,333,56,273,329,4,333,https://pilkada2015.kpu.go.id/surabayakota/sukomanunggal/simomulyo
TPS 30,472,268,32,225,257,11,268,https://pilkada2015.kpu.go.id/surabayakota/sukomanunggal/simomulyo
TPS 1,466,280,41,234,275,5,280,https://pilkada2015.kpu.go.id/surabayakota/sukomanunggal/simomulyo_baru
TPS 2,567,299,48,248,296,3,299,https://pilkada2015.kpu.go.id/surabayakota/sukomanunggal/simomulyo_baru
TPS 3,413,231,17,210,227,4,231,https://pilkada2015.kpu.go.id/surabayakota/sukomanunggal/simomulyo_baru
TPS 4,358,219,10,203,213,6,219,https://pilkada2015.kpu.go.id/surabayakota/sukomanunggal/simomulyo_baru
TPS 5,695,313,28,280,308,5,313,https://pilkada2015.kpu.go.id/surabayakota/sukomanunggal/simomulyo_baru
TPS 6,515,248,30,217,247,1,248,https://pilkada2015.kpu.go.id/surabayakota/sukomanunggal/simomulyo_baru
TPS 7,570,320,46,271,317,3,320,https://pilkada2015.kpu.go.id/surabayakota/sukomanunggal/simomulyo_baru
TPS 8,537,323,41,274,315,8,323,https://pilkada2015.kpu.go.id/surabayakota/sukomanunggal/simomulyo_baru
TPS 9,343,343,22,191,213,0,213,https://pilkada2015.kpu.go.id/surabayakota/sukomanunggal/simomulyo_baru
TPS 10,410,222,23,196,219,3,222,https://pilkada2015.kpu.go.id/surabayakota/sukomanunggal/simomulyo_baru
TPS 11,651,320,43,274,317,3,320,https://pilkada2015.kpu.go.id/surabayakota/sukomanunggal/simomulyo_baru
TPS 12,664,375,47,320,367,8,375,https://pilkada2015.kpu.go.id/surabayakota/sukomanunggal/simomulyo_baru
TPS 13,475,256,31,225,256,0,256,https://pilkada2015.kpu.go.id/surabayakota/sukomanunggal/simomulyo_baru
TPS 14,609,297,39,252,291,6,297,https://pilkada2015.kpu.go.id/surabayakota/sukomanunggal/simomulyo_baru
TPS 15,534,278,28,247,275,3,278,https://pilkada2015.kpu.go.id/surabayakota/sukomanunggal/simomulyo_baru
TPS 16,667,316,28,288,316,0,316,https://pilkada2015.kpu.go.id/surabayakota/sukomanunggal/simomulyo_baru
TPS 17,708,326,60,263,323,3,326,https://pilkada2015.kpu.go.id/surabayakota/sukomanunggal/simomulyo_baru
TPS 18,689,286,30,251,281,5,286,https://pilkada2015.kpu.go.id/surabayakota/sukomanunggal/simomulyo_baru
TPS 19,334,149,16,132,148,1,149,https://pilkada2015.kpu.go.id/surabayakota/sukomanunggal/simomulyo_baru
TPS 20,633,332,29,298,327,5,332,https://pilkada2015.kpu.go.id/surabayakota/sukomanunggal/simomulyo_baru
TPS 21,573,296,41,251,292,4,296,https://pilkada2015.kpu.go.id/surabayakota/sukomanunggal/simomulyo_baru
TPS 22,398,237,32,202,234,3,237,https://pilkada2015.kpu.go.id/surabayakota/sukomanunggal/simomulyo_baru
TPS 23,433,320,27,286,313,7,320,https://pilkada2015.kpu.go.id/surabayakota/sukomanunggal/simomulyo_baru
TPS 24,655,361,45,311,356,5,361,https://pilkada2015.kpu.go.id/surabayakota/sukomanunggal/simomulyo_baru
TPS 25,621,387,42,340,382,5,387,https://pilkada2015.kpu.go.id/surabayakota/sukomanunggal/simomulyo_baru
TPS 26,790,399,50,342,392,7,399,https://pilkada2015.kpu.go.id/surabayakota/sukomanunggal/simomulyo_baru
TPS 27,791,444,39,397,436,8,444,https://pilkada2015.kpu.go.id/surabayakota/sukomanunggal/simomulyo_baru
TPS 28,748,394,45,343,388,6,394,https://pilkada2015.kpu.go.id/surabayakota/sukomanunggal/simomulyo_baru
TPS 29,623,374,40,326,366,8,374,https://pilkada2015.kpu.go.id/surabayakota/sukomanunggal/simomulyo_baru
TPS 30,479,315,25,287,312,3,315,https://pilkada2015.kpu.go.id/surabayakota/sukomanunggal/simomulyo_baru
TPS 31,0,0,42,205,247,2,249,https://pilkada2015.kpu.go.id/surabayakota/sukomanunggal/simomulyo_baru
TPS 32,0,297,40,252,292,5,297,https://pilkada2015.kpu.go.id/surabayakota/sukomanunggal/simomulyo_baru
TPS 33,552,284,27,255,282,2,284,https://pilkada2015.kpu.go.id/surabayakota/sukomanunggal/simomulyo_baru
TPS 34,314,188,16,170,186,2,188,https://pilkada2015.kpu.go.id/surabayakota/sukomanunggal/simomulyo_baru
TPS 35,610,279,29,239,268,11,279,https://pilkada2015.kpu.go.id/surabayakota/sukomanunggal/simomulyo_baru
TPS 36,592,283,19,258,277,6,283,https://pilkada2015.kpu.go.id/surabayakota/sukomanunggal/simomulyo_baru
TPS 37,593,351,35,315,350,1,351,https://pilkada2015.kpu.go.id/surabayakota/sukomanunggal/simomulyo_baru
TPS 38,436,254,21,230,251,3,254,https://pilkada2015.kpu.go.id/surabayakota/sukomanunggal/simomulyo_baru
TPS 39,481,239,21,211,232,7,239,https://pilkada2015.kpu.go.id/surabayakota/sukomanunggal/simomulyo_baru
TPS 40,439,260,29,224,253,7,260,https://pilkada2015.kpu.go.id/surabayakota/sukomanunggal/simomulyo_baru
TPS 41,248,145,32,109,141,4,145,https://pilkada2015.kpu.go.id/surabayakota/sukomanunggal/simomulyo_baru
TPS 42,402,250,47,199,246,4,250,https://pilkada2015.kpu.go.id/surabayakota/sukomanunggal/simomulyo_baru
TPS 43,305,162,21,139,160,2,162,https://pilkada2015.kpu.go.id/surabayakota/sukomanunggal/simomulyo_baru
TPS 44,386,233,30,193,223,10,233,https://pilkada2015.kpu.go.id/surabayakota/sukomanunggal/simomulyo_baru
TPS 45,554,282,28,250,278,4,282,https://pilkada2015.kpu.go.id/surabayakota/sukomanunggal/simomulyo_baru
TPS 46,633,401,35,360,395,6,401,https://pilkada2015.kpu.go.id/surabayakota/sukomanunggal/simomulyo_baru
TPS 47,675,327,38,283,321,6,327,https://pilkada2015.kpu.go.id/surabayakota/sukomanunggal/simomulyo_baru
TPS 48,557,285,33,243,276,9,285,https://pilkada2015.kpu.go.id/surabayakota/sukomanunggal/simomulyo_baru
TPS 49,459,285,46,238,284,1,285,https://pilkada2015.kpu.go.id/surabayakota/sukomanunggal/simomulyo_baru
TPS 50,320,196,19,176,195,1,196,https://pilkada2015.kpu.go.id/surabayakota/sukomanunggal/simomulyo_baru
TPS 51,592,288,29,255,284,4,288,https://pilkada2015.kpu.go.id/surabayakota/sukomanunggal/simomulyo_baru
TPS 52,208,131,9,122,131,0,131,https://pilkada2015.kpu.go.id/surabayakota/sukomanunggal/simomulyo_baru
TPS 1,320,148,15,129,144,4,148,https://pilkada2015.kpu.go.id/surabayakota/sukomanunggal/sonokwijenan
TPS 2,406,140,9,131,140,0,140,https://pilkada2015.kpu.go.id/surabayakota/sukomanunggal/sonokwijenan
TPS 3,316,197,21,173,194,3,197,https://pilkada2015.kpu.go.id/surabayakota/sukomanunggal/sonokwijenan
TPS 4,467,210,10,200,210,0,210,https://pilkada2015.kpu.go.id/surabayakota/sukomanunggal/sonokwijenan
TPS 5,583,261,13,246,259,2,261,https://pilkada2015.kpu.go.id/surabayakota/sukomanunggal/sonokwijenan
TPS 6,559,334,43,287,330,4,334,https://pilkada2015.kpu.go.id/surabayakota/sukomanunggal/sonokwijenan
TPS 7,489,292,48,240,288,4,292,https://pilkada2015.kpu.go.id/surabayakota/sukomanunggal/sonokwijenan
TPS 8,399,205,13,191,204,1,205,https://pilkada2015.kpu.go.id/surabayakota/sukomanunggal/sonokwijenan
TPS 9,536,213,17,196,213,0,213,https://pilkada2015.kpu.go.id/surabayakota/sukomanunggal/sonokwijenan
TPS 10,468,207,20,187,207,0,207,https://pilkada2015.kpu.go.id/surabayakota/sukomanunggal/sonokwijenan
TPS 11,526,281,34,243,277,4,281,https://pilkada2015.kpu.go.id/surabayakota/sukomanunggal/sonokwijenan
TPS 12,627,340,26,311,337,3,340,https://pilkada2015.kpu.go.id/surabayakota/sukomanunggal/sonokwijenan
TPS 1,545,316,60,243,303,13,316,https://pilkada2015.kpu.go.id/surabayakota/sukomanunggal/sukomanunggal
TPS 2,592,346,62,279,341,5,346,https://pilkada2015.kpu.go.id/surabayakota/sukomanunggal/sukomanunggal
TPS 3,571,337,65,267,332,5,337,https://pilkada2015.kpu.go.id/surabayakota/sukomanunggal/sukomanunggal
TPS 4,474,268,42,223,265,3,268,https://pilkada2015.kpu.go.id/surabayakota/sukomanunggal/sukomanunggal
TPS 5,440,254,28,221,249,5,254,https://pilkada2015.kpu.go.id/surabayakota/sukomanunggal/sukomanunggal
TPS 6,560,301,51,248,299,2,301,https://pilkada2015.kpu.go.id/surabayakota/sukomanunggal/sukomanunggal
TPS 7,508,246,30,209,239,7,246,https://pilkada2015.kpu.go.id/surabayakota/sukomanunggal/sukomanunggal
TPS 8,508,245,24,218,242,3,245,https://pilkada2015.kpu.go.id/surabayakota/sukomanunggal/sukomanunggal
TPS 9,503,293,30,260,290,3,293,https://pilkada2015.kpu.go.id/surabayakota/sukomanunggal/sukomanunggal
TPS 10,384,384,77,116,193,3,196,https://pilkada2015.kpu.go.id/surabayakota/sukomanunggal/sukomanunggal
TPS 11,347,184,50,131,181,3,184,https://pilkada2015.kpu.go.id/surabayakota/sukomanunggal/sukomanunggal
TPS 12,478,478,59,200,259,6,265,https://pilkada2015.kpu.go.id/surabayakota/sukomanunggal/sukomanunggal
TPS 13,645,258,10,244,254,4,258,https://pilkada2015.kpu.go.id/surabayakota/sukomanunggal/sukomanunggal
TPS 14,597,230,13,212,225,5,230,https://pilkada2015.kpu.go.id/surabayakota/sukomanunggal/sukomanunggal
TPS 1,412,169,9,159,168,1,169,https://pilkada2015.kpu.go.id/surabayakota/sukomanunggal/tanjungsari
TPS 2,456,246,16,227,243,3,246,https://pilkada2015.kpu.go.id/surabayakota/sukomanunggal/tanjungsari
TPS 3,394,238,17,221,238,0,238,https://pilkada2015.kpu.go.id/surabayakota/sukomanunggal/tanjungsari
TPS 4,544,319,98,213,311,8,319,https://pilkada2015.kpu.go.id/surabayakota/sukomanunggal/tanjungsari
TPS 5,462,303,85,208,293,10,303,https://pilkada2015.kpu.go.id/surabayakota/sukomanunggal/tanjungsari
TPS 6,584,377,122,249,371,6,377,https://pilkada2015.kpu.go.id/surabayakota/sukomanunggal/tanjungsari
TPS 7,500,362,178,180,358,4,362,https://pilkada2015.kpu.go.id/surabayakota/sukomanunggal/tanjungsari
TPS 8,403,259,31,224,255,4,259,https://pilkada2015.kpu.go.id/surabayakota/sukomanunggal/tanjungsari
TPS 9,412,289,49,240,289,0,0,https://pilkada2015.kpu.go.id/surabayakota/sukomanunggal/tanjungsari
TPS 10,544,290,37,251,288,2,290,https://pilkada2015.kpu.go.id/surabayakota/sukomanunggal/tanjungsari
TPS 11,551,297,64,230,294,3,297,https://pilkada2015.kpu.go.id/surabayakota/sukomanunggal/tanjungsari
TPS 12,504,262,17,243,260,2,262,https://pilkada2015.kpu.go.id/surabayakota/sukomanunggal/tanjungsari
TPS 13,508,286,7,279,286,0,286,https://pilkada2015.kpu.go.id/surabayakota/sukomanunggal/tanjungsari
TPS 14,433,160,12,143,155,5,160,https://pilkada2015.kpu.go.id/surabayakota/sukomanunggal/tanjungsari
TPS 15,567,225,17,208,225,0,225,https://pilkada2015.kpu.go.id/surabayakota/sukomanunggal/tanjungsari
TPS 16,298,114,12,102,114,0,114,https://pilkada2015.kpu.go.id/surabayakota/sukomanunggal/tanjungsari
TPS 17,542,226,22,202,224,2,226,https://pilkada2015.kpu.go.id/surabayakota/sukomanunggal/tanjungsari
TPS 18,448,191,10,181,191,0,191,https://pilkada2015.kpu.go.id/surabayakota/sukomanunggal/tanjungsari
TPS 1,372,228,42,184,226,2,228,https://pilkada2015.kpu.go.id/surabayakota/tambaksari/dukuh_setro
TPS 2,562,341,48,290,338,3,341,https://pilkada2015.kpu.go.id/surabayakota/tambaksari/dukuh_setro
TPS 3,353,225,19,201,220,5,225,https://pilkada2015.kpu.go.id/surabayakota/tambaksari/dukuh_setro
TPS 4,516,307,43,258,301,6,307,https://pilkada2015.kpu.go.id/surabayakota/tambaksari/dukuh_setro
TPS 5,563,276,25,248,273,3,276,https://pilkada2015.kpu.go.id/surabayakota/tambaksari/dukuh_setro
TPS 6,601,258,23,225,248,10,258,https://pilkada2015.kpu.go.id/surabayakota/tambaksari/dukuh_setro
TPS 7,556,353,64,280,344,9,353,https://pilkada2015.kpu.go.id/surabayakota/tambaksari/dukuh_setro
TPS 8,511,335,42,288,330,5,335,https://pilkada2015.kpu.go.id/surabayakota/tambaksari/dukuh_setro
TPS 9,428,255,26,228,254,1,255,https://pilkada2015.kpu.go.id/surabayakota/tambaksari/dukuh_setro
TPS 10,442,301,28,264,292,9,301,https://pilkada2015.kpu.go.id/surabayakota/tambaksari/dukuh_setro
TPS 11,420,261,27,233,260,1,261,https://pilkada2015.kpu.go.id/surabayakota/tambaksari/dukuh_setro
TPS 12,536,348,43,299,342,6,348,https://pilkada2015.kpu.go.id/surabayakota/tambaksari/dukuh_setro
TPS 13,543,339,34,302,336,3,339,https://pilkada2015.kpu.go.id/surabayakota/tambaksari/dukuh_setro
TPS 14,440,254,21,231,252,2,254,https://pilkada2015.kpu.go.id/surabayakota/tambaksari/dukuh_setro
TPS 15,546,380,27,343,375,5,380,https://pilkada2015.kpu.go.id/surabayakota/tambaksari/dukuh_setro
TPS 16,488,262,26,257,252,5,262,https://pilkada2015.kpu.go.id/surabayakota/tambaksari/dukuh_setro
TPS 17,474,247,29,218,247,0,247,https://pilkada2015.kpu.go.id/surabayakota/tambaksari/dukuh_setro
TPS 18,476,274,18,252,270,4,274,https://pilkada2015.kpu.go.id/surabayakota/tambaksari/dukuh_setro
TPS 19,505,268,28,235,263,5,268,https://pilkada2015.kpu.go.id/surabayakota/tambaksari/dukuh_setro
TPS 20,652,403,36,360,396,7,403,https://pilkada2015.kpu.go.id/surabayakota/tambaksari/dukuh_setro
TPS 21,553,369,29,333,362,7,369,https://pilkada2015.kpu.go.id/surabayakota/tambaksari/dukuh_setro
TPS 22,702,397,30,362,392,5,397,https://pilkada2015.kpu.go.id/surabayakota/tambaksari/dukuh_setro
TPS 23,715,421,52,365,417,4,421,https://pilkada2015.kpu.go.id/surabayakota/tambaksari/dukuh_setro
TPS 24,458,284,32,247,279,5,284,https://pilkada2015.kpu.go.id/surabayakota/tambaksari/dukuh_setro
TPS 25,461,239,30,202,232,7,239,https://pilkada2015.kpu.go.id/surabayakota/tambaksari/dukuh_setro
TPS 26,688,296,11,285,296,0,296,https://pilkada2015.kpu.go.id/surabayakota/tambaksari/dukuh_setro
TPS 1,527,280,34,241,275,5,280,https://pilkada2015.kpu.go.id/surabayakota/tambaksari/gading
TPS 2,465,239,17,219,236,3,239,https://pilkada2015.kpu.go.id/surabayakota/tambaksari/gading
TPS 3,571,242,9,231,240,2,242,https://pilkada2015.kpu.go.id/surabayakota/tambaksari/gading
TPS 4,478,198,8,189,197,1,198,https://pilkada2015.kpu.go.id/surabayakota/tambaksari/gading
TPS 5,543,245,15,229,244,1,245,https://pilkada2015.kpu.go.id/surabayakota/tambaksari/gading
TPS 6,599,351,39,308,347,4,351,https://pilkada2015.kpu.go.id/surabayakota/tambaksari/gading
TPS 7,486,263,25,237,262,1,263,https://pilkada2015.kpu.go.id/surabayakota/tambaksari/gading
TPS 8,554,319,42,274,316,3,319,https://pilkada2015.kpu.go.id/surabayakota/tambaksari/gading
TPS 9,298,298,29,268,297,1,298,https://pilkada2015.kpu.go.id/surabayakota/tambaksari/gading
TPS 10,523,308,31,271,302,6,308,https://pilkada2015.kpu.go.id/surabayakota/tambaksari/gading
TPS 11,465,246,26,217,243,3,246,https://pilkada2015.kpu.go.id/surabayakota/tambaksari/gading
TPS 12,456,249,30,216,246,3,249,https://pilkada2015.kpu.go.id/surabayakota/tambaksari/gading
TPS 13,446,176,16,159,175,1,176,https://pilkada2015.kpu.go.id/surabayakota/tambaksari/gading
TPS 14,519,249,21,225,246,3,249,https://pilkada2015.kpu.go.id/surabayakota/tambaksari/gading
TPS 15,527,238,11,225,236,2,238,https://pilkada2015.kpu.go.id/surabayakota/tambaksari/gading
TPS 16,533,225,13,210,223,2,225,https://pilkada2015.kpu.go.id/surabayakota/tambaksari/gading
TPS 17,490,278,22,251,273,5,278,https://pilkada2015.kpu.go.id/surabayakota/tambaksari/gading
TPS 18,525,260,29,230,259,1,260,https://pilkada2015.kpu.go.id/surabayakota/tambaksari/gading
TPS 19,571,264,31,228,259,5,264,https://pilkada2015.kpu.go.id/surabayakota/tambaksari/gading
TPS 20,504,271,38,227,265,6,271,https://pilkada2015.kpu.go.id/surabayakota/tambaksari/gading
TPS 21,504,271,26,244,270,1,271,https://pilkada2015.kpu.go.id/surabayakota/tambaksari/gading
TPS 22,488,201,17,182,199,2,201,https://pilkada2015.kpu.go.id/surabayakota/tambaksari/gading
TPS 23,532,173,10,161,171,2,173,https://pilkada2015.kpu.go.id/surabayakota/tambaksari/gading
TPS 24,518,302,43,250,293,9,302,https://pilkada2015.kpu.go.id/surabayakota/tambaksari/gading
TPS 25,528,306,52,247,299,7,306,https://pilkada2015.kpu.go.id/surabayakota/tambaksari/gading
TPS 26,506,258,33,219,252,6,258,https://pilkada2015.kpu.go.id/surabayakota/tambaksari/gading
TPS 27,423,134,6,125,131,3,134,https://pilkada2015.kpu.go.id/surabayakota/tambaksari/gading
TPS 28,484,117,16,97,113,4,117,https://pilkada2015.kpu.go.id/surabayakota/tambaksari/gading
TPS 29,494,300,58,241,299,1,300,https://pilkada2015.kpu.go.id/surabayakota/tambaksari/gading
TPS 30,501,303,30,270,300,3,303,https://pilkada2015.kpu.go.id/surabayakota/tambaksari/gading
TPS 31,440,241,35,201,236,5,241,https://pilkada2015.kpu.go.id/surabayakota/tambaksari/gading
TPS 32,462,263,29,231,260,3,263,https://pilkada2015.kpu.go.id/surabayakota/tambaksari/gading
TPS 33,481,239,32,202,234,5,239,https://pilkada2015.kpu.go.id/surabayakota/tambaksari/gading
TPS 34,609,336,44,289,333,3,336,https://pilkada2015.kpu.go.id/surabayakota/tambaksari/gading
TPS 35,468,222,29,189,218,4,222,https://pilkada2015.kpu.go.id/surabayakota/tambaksari/gading
TPS 36,550,305,32,272,304,1,305,https://pilkada2015.kpu.go.id/surabayakota/tambaksari/gading
TPS 37,575,333,0,0,333,0,333,https://pilkada2015.kpu.go.id/surabayakota/tambaksari/gading
TPS 38,565,290,23,264,287,3,290,https://pilkada2015.kpu.go.id/surabayakota/tambaksari/gading
TPS 39,569,268,33,234,267,1,268,https://pilkada2015.kpu.go.id/surabayakota/tambaksari/gading
TPS 1,438,269,25,241,266,3,269,https://pilkada2015.kpu.go.id/surabayakota/tambaksari/kapasmadya_baru
TPS 2,495,318,30,282,312,6,318,https://pilkada2015.kpu.go.id/surabayakota/tambaksari/kapasmadya_baru
TPS 3,519,278,23,253,276,2,278,https://pilkada2015.kpu.go.id/surabayakota/tambaksari/kapasmadya_baru
TPS 4,491,339,23,314,337,2,339,https://pilkada2015.kpu.go.id/surabayakota/tambaksari/kapasmadya_baru
TPS 5,533,344,40,302,342,2,344,https://pilkada2015.kpu.go.id/surabayakota/tambaksari/kapasmadya_baru
TPS 6,558,310,22,283,305,5,310,https://pilkada2015.kpu.go.id/surabayakota/tambaksari/kapasmadya_baru
TPS 7,486,302,20,281,301,1,302,https://pilkada2015.kpu.go.id/surabayakota/tambaksari/kapasmadya_baru
TPS 8,701,418,49,360,409,9,418,https://pilkada2015.kpu.go.id/surabayakota/tambaksari/kapasmadya_baru
TPS 9,576,321,43,272,315,6,321,https://pilkada2015.kpu.go.id/surabayakota/tambaksari/kapasmadya_baru
TPS 10,465,288,44,238,282,6,288,https://pilkada2015.kpu.go.id/surabayakota/tambaksari/kapasmadya_baru
TPS 11,599,334,29,302,331,3,334,https://pilkada2015.kpu.go.id/surabayakota/tambaksari/kapasmadya_baru
TPS 12,612,342,36,299,335,7,342,https://pilkada2015.kpu.go.id/surabayakota/tambaksari/kapasmadya_baru
TPS 13,525,276,24,250,274,2,276,https://pilkada2015.kpu.go.id/surabayakota/tambaksari/kapasmadya_baru
TPS 14,500,276,22,250,272,4,276,https://pilkada2015.kpu.go.id/surabayakota/tambaksari/kapasmadya_baru
TPS 15,388,247,26,210,236,11,247,https://pilkada2015.kpu.go.id/surabayakota/tambaksari/kapasmadya_baru
TPS 16,403,195,38,150,188,7,195,https://pilkada2015.kpu.go.id/surabayakota/tambaksari/kapasmadya_baru
TPS 17,401,203,39,159,198,5,203,https://pilkada2015.kpu.go.id/surabayakota/tambaksari/kapasmadya_baru
TPS 18,506,283,42,238,280,3,283,https://pilkada2015.kpu.go.id/surabayakota/tambaksari/kapasmadya_baru
TPS 19,592,371,34,329,363,8,371,https://pilkada2015.kpu.go.id/surabayakota/tambaksari/kapasmadya_baru
TPS 20,535,253,0,0,243,10,253,https://pilkada2015.kpu.go.id/surabayakota/tambaksari/kapasmadya_baru
TPS 21,519,311,37,271,308,3,311,https://pilkada2015.kpu.go.id/surabayakota/tambaksari/kapasmadya_baru
TPS 22,315,195,21,170,191,4,195,https://pilkada2015.kpu.go.id/surabayakota/tambaksari/kapasmadya_baru
TPS 23,400,232,36,195,231,1,232,https://pilkada2015.kpu.go.id/surabayakota/tambaksari/kapasmadya_baru
TPS 24,485,295,37,251,288,7,295,https://pilkada2015.kpu.go.id/surabayakota/tambaksari/kapasmadya_baru
TPS 25,412,218,30,187,217,1,218,https://pilkada2015.kpu.go.id/surabayakota/tambaksari/kapasmadya_baru
TPS 26,552,224,30,189,219,5,224,https://pilkada2015.kpu.go.id/surabayakota/tambaksari/kapasmadya_baru
TPS 27,520,283,0,0,282,0,282,https://pilkada2015.kpu.go.id/surabayakota/tambaksari/kapasmadya_baru
TPS 28,531,204,20,182,202,2,204,https://pilkada2015.kpu.go.id/surabayakota/tambaksari/kapasmadya_baru
TPS 29,350,219,37,174,211,8,219,https://pilkada2015.kpu.go.id/surabayakota/tambaksari/kapasmadya_baru
TPS 30,538,280,24,251,275,5,280,https://pilkada2015.kpu.go.id/surabayakota/tambaksari/kapasmadya_baru
TPS 31,528,264,25,234,259,5,264,https://pilkada2015.kpu.go.id/surabayakota/tambaksari/kapasmadya_baru
TPS 32,507,197,26,167,193,4,197,https://pilkada2015.kpu.go.id/surabayakota/tambaksari/kapasmadya_baru
TPS 33,605,275,38,228,266,9,275,https://pilkada2015.kpu.go.id/surabayakota/tambaksari/kapasmadya_baru
TPS 34,438,218,30,180,210,8,218,https://pilkada2015.kpu.go.id/surabayakota/tambaksari/kapasmadya_baru
TPS 35,492,227,28,194,222,5,227,https://pilkada2015.kpu.go.id/surabayakota/tambaksari/kapasmadya_baru
TPS 36,370,171,20,148,168,3,171,https://pilkada2015.kpu.go.id/surabayakota/tambaksari/kapasmadya_baru
TPS 37,434,128,41,86,127,1,128,https://pilkada2015.kpu.go.id/surabayakota/tambaksari/kapasmadya_baru
TPS 38,488,268,46,215,261,7,268,https://pilkada2015.kpu.go.id/surabayakota/tambaksari/kapasmadya_baru
TPS 39,544,296,69,221,290,6,296,https://pilkada2015.kpu.go.id/surabayakota/tambaksari/kapasmadya_baru
TPS 40,529,261,44,208,252,9,261,https://pilkada2015.kpu.go.id/surabayakota/tambaksari/kapasmadya_baru
TPS 41,536,222,53,166,219,3,222,https://pilkada2015.kpu.go.id/surabayakota/tambaksari/kapasmadya_baru
TPS 42,476,204,28,173,201,3,204,https://pilkada2015.kpu.go.id/surabayakota/tambaksari/kapasmadya_baru
TPS 43,577,232,44,183,227,5,232,https://pilkada2015.kpu.go.id/surabayakota/tambaksari/kapasmadya_baru
TPS 44,577,147,24,127,145,2,147,https://pilkada2015.kpu.go.id/surabayakota/tambaksari/kapasmadya_baru
TPS 45,585,248,39,208,247,1,248,https://pilkada2015.kpu.go.id/surabayakota/tambaksari/kapasmadya_baru
TPS 46,526,233,48,180,228,5,233,https://pilkada2015.kpu.go.id/surabayakota/tambaksari/kapasmadya_baru
TPS 47,515,176,40,133,173,3,176,https://pilkada2015.kpu.go.id/surabayakota/tambaksari/kapasmadya_baru
TPS 48,588,178,42,133,175,3,178,https://pilkada2015.kpu.go.id/surabayakota/tambaksari/kapasmadya_baru
TPS 49,521,205,46,155,201,4,205,https://pilkada2015.kpu.go.id/surabayakota/tambaksari/kapasmadya_baru
TPS 50,575,219,38,178,216,3,219,https://pilkada2015.kpu.go.id/surabayakota/tambaksari/kapasmadya_baru
TPS 51,578,246,36,206,242,4,246,https://pilkada2015.kpu.go.id/surabayakota/tambaksari/kapasmadya_baru
TPS 52,475,245,51,189,240,5,245,https://pilkada2015.kpu.go.id/surabayakota/tambaksari/kapasmadya_baru
TPS 53,411,178,28,141,169,9,178,https://pilkada2015.kpu.go.id/surabayakota/tambaksari/kapasmadya_baru
TPS 1,515,271,33,234,267,4,271,https://pilkada2015.kpu.go.id/surabayakota/tambaksari/pacar_keling
TPS 2,547,327,30,293,323,4,327,https://pilkada2015.kpu.go.id/surabayakota/tambaksari/pacar_keling
TPS 3,412,213,18,191,209,4,213,https://pilkada2015.kpu.go.id/surabayakota/tambaksari/pacar_keling
TPS 4,395,244,26,213,239,5,244,https://pilkada2015.kpu.go.id/surabayakota/tambaksari/pacar_keling
TPS 5,455,226,22,203,225,1,226,https://pilkada2015.kpu.go.id/surabayakota/tambaksari/pacar_keling
TPS 6,495,269,36,230,266,3,269,https://pilkada2015.kpu.go.id/surabayakota/tambaksari/pacar_keling
TPS 7,475,276,30,245,275,1,276,https://pilkada2015.kpu.go.id/surabayakota/tambaksari/pacar_keling
TPS 8,497,267,32,234,266,1,267,https://pilkada2015.kpu.go.id/surabayakota/tambaksari/pacar_keling
TPS 9,488,293,36,253,289,4,293,https://pilkada2015.kpu.go.id/surabayakota/tambaksari/pacar_keling
TPS 10,618,343,61,276,337,6,343,https://pilkada2015.kpu.go.id/surabayakota/tambaksari/pacar_keling
TPS 11,470,225,23,200,223,2,225,https://pilkada2015.kpu.go.id/surabayakota/tambaksari/pacar_keling
TPS 12,495,309,29,273,302,7,309,https://pilkada2015.kpu.go.id/surabayakota/tambaksari/pacar_keling
TPS 13,528,273,27,244,271,2,273,https://pilkada2015.kpu.go.id/surabayakota/tambaksari/pacar_keling
TPS 14,373,233,34,195,229,4,233,https://pilkada2015.kpu.go.id/surabayakota/tambaksari/pacar_keling
TPS 15,415,247,27,219,246,1,247,https://pilkada2015.kpu.go.id/surabayakota/tambaksari/pacar_keling
TPS 16,392,193,27,166,193,0,193,https://pilkada2015.kpu.go.id/surabayakota/tambaksari/pacar_keling
TPS 17,531,299,29,266,295,4,299,https://pilkada2015.kpu.go.id/surabayakota/tambaksari/pacar_keling
TPS 18,382,236,40,191,231,5,236,https://pilkada2015.kpu.go.id/surabayakota/tambaksari/pacar_keling
TPS 19,521,277,59,213,272,5,277,https://pilkada2015.kpu.go.id/surabayakota/tambaksari/pacar_keling
TPS 20,507,189,30,153,183,6,189,https://pilkada2015.kpu.go.id/surabayakota/tambaksari/pacar_keling
TPS 21,472,250,29,216,245,5,250,https://pilkada2015.kpu.go.id/surabayakota/tambaksari/pacar_keling
TPS 22,558,279,36,240,276,3,279,https://pilkada2015.kpu.go.id/surabayakota/tambaksari/pacar_keling
TPS 23,572,288,48,234,282,6,288,https://pilkada2015.kpu.go.id/surabayakota/tambaksari/pacar_keling
TPS 24,423,216,52,164,216,0,216,https://pilkada2015.kpu.go.id/surabayakota/tambaksari/pacar_keling
TPS 25,498,254,49,197,246,8,254,https://pilkada2015.kpu.go.id/surabayakota/tambaksari/pacar_keling
TPS 26,432,259,30,228,258,1,259,https://pilkada2015.kpu.go.id/surabayakota/tambaksari/pacar_keling
TPS 27,406,271,14,257,271,0,271,https://pilkada2015.kpu.go.id/surabayakota/tambaksari/pacar_keling
TPS 28,573,309,16,291,307,2,309,https://pilkada2015.kpu.go.id/surabayakota/tambaksari/pacar_keling
TPS 29,608,188,22,164,186,2,188,https://pilkada2015.kpu.go.id/surabayakota/tambaksari/pacar_keling
TPS 30,518,335,23,302,325,10,335,https://pilkada2015.kpu.go.id/surabayakota/tambaksari/pacar_keling
TPS 31,464,278,29,247,276,2,278,https://pilkada2015.kpu.go.id/surabayakota/tambaksari/pacar_keling
TPS 32,550,331,47,277,324,7,331,https://pilkada2015.kpu.go.id/surabayakota/tambaksari/pacar_keling
TPS 1,406,202,26,173,199,3,202,https://pilkada2015.kpu.go.id/surabayakota/tambaksari/pacarkembang
TPS 2,471,252,28,223,248,4,252,https://pilkada2015.kpu.go.id/surabayakota/tambaksari/pacarkembang
TPS 3,629,256,38,213,251,5,256,https://pilkada2015.kpu.go.id/surabayakota/tambaksari/pacarkembang
TPS 4,445,181,32,143,175,6,181,https://pilkada2015.kpu.go.id/surabayakota/tambaksari/pacarkembang
TPS 5,483,256,50,203,253,3,256,https://pilkada2015.kpu.go.id/surabayakota/tambaksari/pacarkembang
TPS 6,510,237,19,216,235,2,237,https://pilkada2015.kpu.go.id/surabayakota/tambaksari/pacarkembang
TPS 7,436,255,21,229,250,5,255,https://pilkada2015.kpu.go.id/surabayakota/tambaksari/pacarkembang
TPS 8,526,294,45,245,290,4,294,https://pilkada2015.kpu.go.id/surabayakota/tambaksari/pacarkembang
TPS 9,509,249,29,219,248,1,249,https://pilkada2015.kpu.go.id/surabayakota/tambaksari/pacarkembang
TPS 10,467,258,37,216,253,5,258,https://pilkada2015.kpu.go.id/surabayakota/tambaksari/pacarkembang
TPS 11,461,246,19,223,242,4,246,https://pilkada2015.kpu.go.id/surabayakota/tambaksari/pacarkembang
TPS 12,513,243,54,181,235,8,243,https://pilkada2015.kpu.go.id/surabayakota/tambaksari/pacarkembang
TPS 13,468,264,36,227,263,1,264,https://pilkada2015.kpu.go.id/surabayakota/tambaksari/pacarkembang
TPS 14,556,304,32,268,300,4,304,https://pilkada2015.kpu.go.id/surabayakota/tambaksari/pacarkembang
TPS 15,538,322,23,296,319,3,322,https://pilkada2015.kpu.go.id/surabayakota/tambaksari/pacarkembang
TPS 16,512,297,23,268,291,6,297,https://pilkada2015.kpu.go.id/surabayakota/tambaksari/pacarkembang
TPS 17,537,237,18,217,235,2,237,https://pilkada2015.kpu.go.id/surabayakota/tambaksari/pacarkembang
TPS 18,553,243,17,223,240,3,243,https://pilkada2015.kpu.go.id/surabayakota/tambaksari/pacarkembang
TPS 19,514,297,54,241,295,2,297,https://pilkada2015.kpu.go.id/surabayakota/tambaksari/pacarkembang
TPS 20,416,259,31,226,257,2,259,https://pilkada2015.kpu.go.id/surabayakota/tambaksari/pacarkembang
TPS 21,549,327,37,283,320,7,327,https://pilkada2015.kpu.go.id/surabayakota/tambaksari/pacarkembang
TPS 22,568,319,42,271,313,6,319,https://pilkada2015.kpu.go.id/surabayakota/tambaksari/pacarkembang
TPS 23,449,257,33,223,256,1,257,https://pilkada2015.kpu.go.id/surabayakota/tambaksari/pacarkembang
TPS 24,532,312,32,272,304,8,312,https://pilkada2015.kpu.go.id/surabayakota/tambaksari/pacarkembang
TPS 25,490,231,24,204,228,3,231,https://pilkada2015.kpu.go.id/surabayakota/tambaksari/pacarkembang
TPS 26,410,193,24,164,188,5,193,https://pilkada2015.kpu.go.id/surabayakota/tambaksari/pacarkembang
TPS 27,472,219,24,192,216,3,219,https://pilkada2015.kpu.go.id/surabayakota/tambaksari/pacarkembang
TPS 28,488,262,28,234,262,0,262,https://pilkada2015.kpu.go.id/surabayakota/tambaksari/pacarkembang
TPS 29,452,247,37,207,244,3,247,https://pilkada2015.kpu.go.id/surabayakota/tambaksari/pacarkembang
TPS 30,469,249,21,225,246,3,249,https://pilkada2015.kpu.go.id/surabayakota/tambaksari/pacarkembang
TPS 31,493,276,36,236,272,4,276,https://pilkada2015.kpu.go.id/surabayakota/tambaksari/pacarkembang
TPS 32,435,244,35,205,240,4,244,https://pilkada2015.kpu.go.id/surabayakota/tambaksari/pacarkembang
TPS 33,392,253,32,212,244,9,253,https://pilkada2015.kpu.go.id/surabayakota/tambaksari/pacarkembang
TPS 34,491,229,22,205,227,2,229,https://pilkada2015.kpu.go.id/surabayakota/tambaksari/pacarkembang
TPS 35,500,251,22,226,248,3,251,https://pilkada2015.kpu.go.id/surabayakota/tambaksari/pacarkembang
TPS 36,494,239,19,216,235,4,239,https://pilkada2015.kpu.go.id/surabayakota/tambaksari/pacarkembang
TPS 37,433,240,20,218,238,2,240,https://pilkada2015.kpu.go.id/surabayakota/tambaksari/pacarkembang
TPS 38,405,246,27,219,246,0,246,https://pilkada2015.kpu.go.id/surabayakota/tambaksari/pacarkembang
TPS 39,477,261,36,217,253,8,261,https://pilkada2015.kpu.go.id/surabayakota/tambaksari/pacarkembang
TPS 40,550,234,35,197,232,2,234,https://pilkada2015.kpu.go.id/surabayakota/tambaksari/pacarkembang
TPS 41,539,225,27,194,221,4,225,https://pilkada2015.kpu.go.id/surabayakota/tambaksari/pacarkembang
TPS 42,514,284,37,245,282,2,284,https://pilkada2015.kpu.go.id/surabayakota/tambaksari/pacarkembang
TPS 43,441,241,36,197,233,8,241,https://pilkada2015.kpu.go.id/surabayakota/tambaksari/pacarkembang
TPS 44,423,183,14,167,181,2,183,https://pilkada2015.kpu.go.id/surabayakota/tambaksari/pacarkembang
TPS 45,446,242,29,210,239,3,242,https://pilkada2015.kpu.go.id/surabayakota/tambaksari/pacarkembang
TPS 46,505,303,23,275,298,5,303,https://pilkada2015.kpu.go.id/surabayakota/tambaksari/pacarkembang
TPS 47,471,299,29,262,291,8,299,https://pilkada2015.kpu.go.id/surabayakota/tambaksari/pacarkembang
TPS 48,519,339,42,292,334,5,339,https://pilkada2015.kpu.go.id/surabayakota/tambaksari/pacarkembang
TPS 49,453,278,37,237,274,4,278,https://pilkada2015.kpu.go.id/surabayakota/tambaksari/pacarkembang
TPS 50,542,258,23,233,256,2,258,https://pilkada2015.kpu.go.id/surabayakota/tambaksari/pacarkembang
TPS 51,463,289,36,248,284,5,289,https://pilkada2015.kpu.go.id/surabayakota/tambaksari/pacarkembang
TPS 52,338,338,31,304,335,3,338,https://pilkada2015.kpu.go.id/surabayakota/tambaksari/pacarkembang
TPS 53,605,340,33,302,335,5,340,https://pilkada2015.kpu.go.id/surabayakota/tambaksari/pacarkembang
TPS 54,568,363,45,314,359,4,363,https://pilkada2015.kpu.go.id/surabayakota/tambaksari/pacarkembang
TPS 55,434,279,39,237,276,3,279,https://pilkada2015.kpu.go.id/surabayakota/tambaksari/pacarkembang
TPS 56,479,252,29,220,249,3,252,https://pilkada2015.kpu.go.id/surabayakota/tambaksari/pacarkembang
TPS 1,531,272,62,203,265,7,272,https://pilkada2015.kpu.go.id/surabayakota/tambaksari/ploso
TPS 2,555,281,77,197,274,7,281,https://pilkada2015.kpu.go.id/surabayakota/tambaksari/ploso
TPS 3,455,266,59,201,260,6,266,https://pilkada2015.kpu.go.id/surabayakota/tambaksari/ploso
TPS 4,379,190,45,136,181,9,190,https://pilkada2015.kpu.go.id/surabayakota/tambaksari/ploso
TPS 5,600,263,44,210,254,9,263,https://pilkada2015.kpu.go.id/surabayakota/tambaksari/ploso
TPS 6,543,280,50,228,278,2,280,https://pilkada2015.kpu.go.id/surabayakota/tambaksari/ploso
TPS 7,527,228,21,203,224,4,228,https://pilkada2015.kpu.go.id/surabayakota/tambaksari/ploso
TPS 8,444,260,26,233,259,1,260,https://pilkada2015.kpu.go.id/surabayakota/tambaksari/ploso
TPS 9,463,261,30,227,257,4,261,https://pilkada2015.kpu.go.id/surabayakota/tambaksari/ploso
TPS 10,532,273,57,211,268,5,273,https://pilkada2015.kpu.go.id/surabayakota/tambaksari/ploso
TPS 11,542,274,30,239,269,5,274,https://pilkada2015.kpu.go.id/surabayakota/tambaksari/ploso
TPS 12,546,269,0,0,265,4,269,https://pilkada2015.kpu.go.id/surabayakota/tambaksari/ploso
TPS 13,491,222,21,194,215,7,222,https://pilkada2015.kpu.go.id/surabayakota/tambaksari/ploso
TPS 14,491,314,26,286,312,2,314,https://pilkada2015.kpu.go.id/surabayakota/tambaksari/ploso
TPS 15,497,258,30,227,257,1,258,https://pilkada2015.kpu.go.id/surabayakota/tambaksari/ploso
TPS 16,524,290,32,255,287,3,290,https://pilkada2015.kpu.go.id/surabayakota/tambaksari/ploso
TPS 17,479,274,35,234,269,5,274,https://pilkada2015.kpu.go.id/surabayakota/tambaksari/ploso
TPS 18,545,260,21,236,257,3,260,https://pilkada2015.kpu.go.id/surabayakota/tambaksari/ploso
TPS 19,501,304,47,250,297,7,304,https://pilkada2015.kpu.go.id/surabayakota/tambaksari/ploso
TPS 20,559,330,33,290,323,7,330,https://pilkada2015.kpu.go.id/surabayakota/tambaksari/ploso
TPS 21,539,270,30,236,266,4,270,https://pilkada2015.kpu.go.id/surabayakota/tambaksari/ploso
TPS 22,531,307,41,254,295,12,307,https://pilkada2015.kpu.go.id/surabayakota/tambaksari/ploso
TPS 23,561,295,41,248,289,6,295,https://pilkada2015.kpu.go.id/surabayakota/tambaksari/ploso
TPS 24,506,237,26,206,232,5,237,https://pilkada2015.kpu.go.id/surabayakota/tambaksari/ploso
TPS 25,463,259,26,229,255,4,259,https://pilkada2015.kpu.go.id/surabayakota/tambaksari/ploso
TPS 26,458,272,28,241,269,3,272,https://pilkada2015.kpu.go.id/surabayakota/tambaksari/ploso
TPS 27,505,273,30,240,270,3,273,https://pilkada2015.kpu.go.id/surabayakota/tambaksari/ploso
TPS 28,438,258,14,242,256,2,258,https://pilkada2015.kpu.go.id/surabayakota/tambaksari/ploso
TPS 29,518,211,16,194,210,1,211,https://pilkada2015.kpu.go.id/surabayakota/tambaksari/ploso
TPS 30,467,217,16,199,215,2,217,https://pilkada2015.kpu.go.id/surabayakota/tambaksari/ploso
TPS 31,380,200,18,177,195,5,200,https://pilkada2015.kpu.go.id/surabayakota/tambaksari/ploso
TPS 32,470,278,27,248,275,3,278,https://pilkada2015.kpu.go.id/surabayakota/tambaksari/ploso
TPS 33,493,267,29,235,264,3,267,https://pilkada2015.kpu.go.id/surabayakota/tambaksari/ploso
TPS 34,519,303,38,259,297,6,303,https://pilkada2015.kpu.go.id/surabayakota/tambaksari/ploso
TPS 35,464,243,12,230,242,1,243,https://pilkada2015.kpu.go.id/surabayakota/tambaksari/ploso
TPS 36,545,266,21,238,259,7,266,https://pilkada2015.kpu.go.id/surabayakota/tambaksari/ploso
TPS 37,514,279,18,250,268,11,279,https://pilkada2015.kpu.go.id/surabayakota/tambaksari/ploso
TPS 38,428,236,25,211,236,0,236,https://pilkada2015.kpu.go.id/surabayakota/tambaksari/ploso
TPS 39,472,261,19,240,259,2,261,https://pilkada2015.kpu.go.id/surabayakota/tambaksari/ploso
TPS 40,584,210,28,181,209,1,210,https://pilkada2015.kpu.go.id/surabayakota/tambaksari/ploso
TPS 41,477,209,18,187,205,4,209,https://pilkada2015.kpu.go.id/surabayakota/tambaksari/ploso
TPS 42,495,251,15,236,251,0,251,https://pilkada2015.kpu.go.id/surabayakota/tambaksari/ploso
TPS 43,285,284,26,253,274,5,284,https://pilkada2015.kpu.go.id/surabayakota/tambaksari/ploso
TPS 44,420,209,31,176,207,2,209,https://pilkada2015.kpu.go.id/surabayakota/tambaksari/ploso
TPS 45,294,263,21,241,262,1,263,https://pilkada2015.kpu.go.id/surabayakota/tambaksari/ploso
TPS 46,600,295,18,274,292,3,295,https://pilkada2015.kpu.go.id/surabayakota/tambaksari/ploso
TPS 47,553,291,46,238,284,7,291,https://pilkada2015.kpu.go.id/surabayakota/tambaksari/ploso
TPS 48,760,378,36,335,371,7,378,https://pilkada2015.kpu.go.id/surabayakota/tambaksari/ploso
TPS 1,534,291,44,241,285,6,291,https://pilkada2015.kpu.go.id/surabayakota/tambaksari/rangkah
TPS 2,450,251,36,213,249,2,251,https://pilkada2015.kpu.go.id/surabayakota/tambaksari/rangkah
TPS 3,562,225,31,193,224,1,225,https://pilkada2015.kpu.go.id/surabayakota/tambaksari/rangkah
TPS 4,594,353,37,313,350,3,353,https://pilkada2015.kpu.go.id/surabayakota/tambaksari/rangkah
TPS 5,437,247,26,216,242,5,247,https://pilkada2015.kpu.go.id/surabayakota/tambaksari/rangkah
TPS 6,542,282,34,243,277,5,282,https://pilkada2015.kpu.go.id/surabayakota/tambaksari/rangkah
TPS 7,678,341,54,280,334,7,341,https://pilkada2015.kpu.go.id/surabayakota/tambaksari/rangkah
TPS 8,551,294,36,258,294,0,294,https://pilkada2015.kpu.go.id/surabayakota/tambaksari/rangkah
TPS 9,541,324,41,278,319,5,324,https://pilkada2015.kpu.go.id/surabayakota/tambaksari/rangkah
TPS 10,548,327,34,290,324,3,327,https://pilkada2015.kpu.go.id/surabayakota/tambaksari/rangkah
TPS 11,503,300,37,261,298,2,300,https://pilkada2015.kpu.go.id/surabayakota/tambaksari/rangkah
TPS 12,351,204,44,158,202,2,204,https://pilkada2015.kpu.go.id/surabayakota/tambaksari/rangkah
TPS 13,380,195,19,175,194,1,195,https://pilkada2015.kpu.go.id/surabayakota/tambaksari/rangkah
TPS 14,441,268,25,234,259,9,268,https://pilkada2015.kpu.go.id/surabayakota/tambaksari/rangkah
TPS 15,435,244,22,218,240,4,244,https://pilkada2015.kpu.go.id/surabayakota/tambaksari/rangkah
TPS 16,534,335,63,266,329,6,335,https://pilkada2015.kpu.go.id/surabayakota/tambaksari/rangkah
TPS 17,451,265,35,220,255,10,265,https://pilkada2015.kpu.go.id/surabayakota/tambaksari/rangkah
TPS 18,532,340,54,273,327,13,340,https://pilkada2015.kpu.go.id/surabayakota/tambaksari/rangkah
TPS 19,496,253,30,215,245,8,253,https://pilkada2015.kpu.go.id/surabayakota/tambaksari/rangkah
TPS 20,411,215,22,188,210,5,215,https://pilkada2015.kpu.go.id/surabayakota/tambaksari/rangkah
TPS 21,448,252,32,214,246,6,252,https://pilkada2015.kpu.go.id/surabayakota/tambaksari/rangkah
TPS 22,382,240,27,209,236,4,240,https://pilkada2015.kpu.go.id/surabayakota/tambaksari/rangkah
TPS 23,496,268,41,222,263,5,268,https://pilkada2015.kpu.go.id/surabayakota/tambaksari/rangkah
TPS 24,395,225,26,191,217,8,225,https://pilkada2015.kpu.go.id/surabayakota/tambaksari/rangkah
TPS 25,462,237,42,192,234,3,237,https://pilkada2015.kpu.go.id/surabayakota/tambaksari/rangkah
TPS 1,526,217,14,202,216,1,217,https://pilkada2015.kpu.go.id/surabayakota/tambaksari/tambaksari
TPS 2,479,243,21,216,237,6,243,https://pilkada2015.kpu.go.id/surabayakota/tambaksari/tambaksari
TPS 3,490,284,28,248,276,8,284,https://pilkada2015.kpu.go.id/surabayakota/tambaksari/tambaksari
TPS 4,662,315,51,256,307,8,315,https://pilkada2015.kpu.go.id/surabayakota/tambaksari/tambaksari
TPS 5,434,275,33,238,271,4,275,https://pilkada2015.kpu.go.id/surabayakota/tambaksari/tambaksari
TPS 6,438,280,33,242,275,5,280,https://pilkada2015.kpu.go.id/surabayakota/tambaksari/tambaksari
TPS 7,496,287,28,253,281,6,287,https://pilkada2015.kpu.go.id/surabayakota/tambaksari/tambaksari
TPS 8,478,275,30,240,270,5,275,https://pilkada2015.kpu.go.id/surabayakota/tambaksari/tambaksari
TPS 9,508,288,32,249,281,7,288,https://pilkada2015.kpu.go.id/surabayakota/tambaksari/tambaksari
TPS 10,455,263,33,228,261,2,263,https://pilkada2015.kpu.go.id/surabayakota/tambaksari/tambaksari
TPS 11,464,246,24,218,242,4,246,https://pilkada2015.kpu.go.id/surabayakota/tambaksari/tambaksari
TPS 12,403,240,32,199,231,9,240,https://pilkada2015.kpu.go.id/surabayakota/tambaksari/tambaksari
TPS 13,458,228,28,197,225,3,228,https://pilkada2015.kpu.go.id/surabayakota/tambaksari/tambaksari
TPS 14,482,230,37,188,225,5,230,https://pilkada2015.kpu.go.id/surabayakota/tambaksari/tambaksari
TPS 15,382,187,28,156,184,3,187,https://pilkada2015.kpu.go.id/surabayakota/tambaksari/tambaksari
TPS 16,373,173,29,139,168,5,173,https://pilkada2015.kpu.go.id/surabayakota/tambaksari/tambaksari
TPS 17,524,211,19,188,207,4,211,https://pilkada2015.kpu.go.id/surabayakota/tambaksari/tambaksari
TPS 18,469,256,31,222,253,3,256,https://pilkada2015.kpu.go.id/surabayakota/tambaksari/tambaksari
TPS 19,602,350,40,303,343,7,350,https://pilkada2015.kpu.go.id/surabayakota/tambaksari/tambaksari
TPS 20,590,235,35,199,234,1,235,https://pilkada2015.kpu.go.id/surabayakota/tambaksari/tambaksari
TPS 21,661,262,42,213,255,7,262,https://pilkada2015.kpu.go.id/surabayakota/tambaksari/tambaksari
TPS 22,666,290,31,250,281,9,290,https://pilkada2015.kpu.go.id/surabayakota/tambaksari/tambaksari
TPS 23,502,264,40,217,257,7,264,https://pilkada2015.kpu.go.id/surabayakota/tambaksari/tambaksari
TPS 24,508,281,40,240,280,1,281,https://pilkada2015.kpu.go.id/surabayakota/tambaksari/tambaksari
TPS 25,314,163,16,144,160,3,163,https://pilkada2015.kpu.go.id/surabayakota/tambaksari/tambaksari
TPS 26,533,281,34,246,280,1,281,https://pilkada2015.kpu.go.id/surabayakota/tambaksari/tambaksari
TPS 27,525,253,31,220,251,2,253,https://pilkada2015.kpu.go.id/surabayakota/tambaksari/tambaksari
TPS 28,527,267,40,222,262,5,267,https://pilkada2015.kpu.go.id/surabayakota/tambaksari/tambaksari
TPS 1,435,232,27,199,226,6,232,https://pilkada2015.kpu.go.id/surabayakota/tandes/balongsari
TPS 2,388,240,29,209,238,2,240,https://pilkada2015.kpu.go.id/surabayakota/tandes/balongsari
TPS 3,440,271,46,223,269,2,271,https://pilkada2015.kpu.go.id/surabayakota/tandes/balongsari
TPS 4,457,289,32,253,285,4,289,https://pilkada2015.kpu.go.id/surabayakota/tandes/balongsari
TPS 5,450,264,28,234,262,2,264,https://pilkada2015.kpu.go.id/surabayakota/tandes/balongsari
TPS 6,449,249,51,195,246,3,249,https://pilkada2015.kpu.go.id/surabayakota/tandes/balongsari
TPS 7,442,276,54,219,273,3,276,https://pilkada2015.kpu.go.id/surabayakota/tandes/balongsari
TPS 8,530,350,86,254,340,10,350,https://pilkada2015.kpu.go.id/surabayakota/tandes/balongsari
TPS 9,630,332,36,286,322,10,332,https://pilkada2015.kpu.go.id/surabayakota/tandes/balongsari
TPS 10,580,237,32,200,232,5,237,https://pilkada2015.kpu.go.id/surabayakota/tandes/balongsari
TPS 11,601,319,30,282,312,7,319,https://pilkada2015.kpu.go.id/surabayakota/tandes/balongsari
TPS 12,546,322,45,276,321,1,322,https://pilkada2015.kpu.go.id/surabayakota/tandes/balongsari
TPS 13,481,278,34,241,275,3,278,https://pilkada2015.kpu.go.id/surabayakota/tandes/balongsari
TPS 1,478,308,35,271,306,2,308,https://pilkada2015.kpu.go.id/surabayakota/tandes/banjar_sugihan
TPS 2,394,238,26,211,237,1,238,https://pilkada2015.kpu.go.id/surabayakota/tandes/banjar_sugihan
TPS 3,367,220,33,184,217,3,220,https://pilkada2015.kpu.go.id/surabayakota/tandes/banjar_sugihan
TPS 4,538,308,31,272,303,5,308,https://pilkada2015.kpu.go.id/surabayakota/tandes/banjar_sugihan
TPS 5,512,323,34,284,318,5,323,https://pilkada2015.kpu.go.id/surabayakota/tandes/banjar_sugihan
TPS 6,381,245,32,208,240,5,245,https://pilkada2015.kpu.go.id/surabayakota/tandes/banjar_sugihan
TPS 7,601,363,42,319,361,2,363,https://pilkada2015.kpu.go.id/surabayakota/tandes/banjar_sugihan
TPS 8,669,408,60,342,402,6,408,https://pilkada2015.kpu.go.id/surabayakota/tandes/banjar_sugihan
TPS 9,449,295,27,264,291,4,295,https://pilkada2015.kpu.go.id/surabayakota/tandes/banjar_sugihan
TPS 10,470,272,56,210,266,6,272,https://pilkada2015.kpu.go.id/surabayakota/tandes/banjar_sugihan
TPS 11,472,281,59,220,279,2,281,https://pilkada2015.kpu.go.id/surabayakota/tandes/banjar_sugihan
TPS 12,475,306,63,236,299,7,306,https://pilkada2015.kpu.go.id/surabayakota/tandes/banjar_sugihan
TPS 13,463,309,58,247,305,4,309,https://pilkada2015.kpu.go.id/surabayakota/tandes/banjar_sugihan
TPS 14,517,282,67,207,274,8,282,https://pilkada2015.kpu.go.id/surabayakota/tandes/banjar_sugihan
TPS 15,463,282,65,209,274,8,282,https://pilkada2015.kpu.go.id/surabayakota/tandes/banjar_sugihan
TPS 1,539,383,35,343,378,5,383,https://pilkada2015.kpu.go.id/surabayakota/tandes/karang_poh
TPS 2,585,339,39,297,336,3,339,https://pilkada2015.kpu.go.id/surabayakota/tandes/karang_poh
TPS 3,377,216,27,185,212,4,216,https://pilkada2015.kpu.go.id/surabayakota/tandes/karang_poh
TPS 4,341,206,25,178,203,3,206,https://pilkada2015.kpu.go.id/surabayakota/tandes/karang_poh
TPS 5,460,236,21,209,230,6,236,https://pilkada2015.kpu.go.id/surabayakota/tandes/karang_poh
TPS 6,500,306,17,289,306,0,306,https://pilkada2015.kpu.go.id/surabayakota/tandes/karang_poh
TPS 7,616,381,19,358,377,4,381,https://pilkada2015.kpu.go.id/surabayakota/tandes/karang_poh
TPS 8,548,244,34,208,242,2,244,https://pilkada2015.kpu.go.id/surabayakota/tandes/karang_poh
TPS 9,640,372,87,282,369,3,372,https://pilkada2015.kpu.go.id/surabayakota/tandes/karang_poh
TPS 10,630,316,106,205,311,5,316,https://pilkada2015.kpu.go.id/surabayakota/tandes/karang_poh
TPS 11,613,334,92,241,333,1,334,https://pilkada2015.kpu.go.id/surabayakota/tandes/karang_poh
TPS 12,611,272,63,206,269,3,272,https://pilkada2015.kpu.go.id/surabayakota/tandes/karang_poh
TPS 13,651,298,54,239,293,5,298,https://pilkada2015.kpu.go.id/surabayakota/tandes/karang_poh
TPS 14,364,236,29,207,236,0,236,https://pilkada2015.kpu.go.id/surabayakota/tandes/karang_poh
TPS 15,286,174,6,167,173,1,174,https://pilkada2015.kpu.go.id/surabayakota/tandes/karang_poh
TPS 16,435,306,38,266,304,2,306,https://pilkada2015.kpu.go.id/surabayakota/tandes/karang_poh
TPS 17,600,374,36,332,368,6,374,https://pilkada2015.kpu.go.id/surabayakota/tandes/karang_poh
TPS 18,502,294,22,265,287,7,294,https://pilkada2015.kpu.go.id/surabayakota/tandes/karang_poh
TPS 19,538,323,37,283,320,3,323,https://pilkada2015.kpu.go.id/surabayakota/tandes/karang_poh
TPS 1,435,229,31,195,226,3,229,https://pilkada2015.kpu.go.id/surabayakota/tandes/manukan_kulon
TPS 2,628,301,49,250,299,2,301,https://pilkada2015.kpu.go.id/surabayakota/tandes/manukan_kulon
TPS 3,420,217,23,192,215,2,217,https://pilkada2015.kpu.go.id/surabayakota/tandes/manukan_kulon
TPS 4,316,172,15,155,170,2,172,https://pilkada2015.kpu.go.id/surabayakota/tandes/manukan_kulon
TPS 5,0,361,37,317,354,7,361,https://pilkada2015.kpu.go.id/surabayakota/tandes/manukan_kulon
TPS 6,372,249,24,222,246,3,249,https://pilkada2015.kpu.go.id/surabayakota/tandes/manukan_kulon
TPS 7,339,215,26,188,214,1,215,https://pilkada2015.kpu.go.id/surabayakota/tandes/manukan_kulon
TPS 8,401,241,45,192,237,4,241,https://pilkada2015.kpu.go.id/surabayakota/tandes/manukan_kulon
TPS 9,303,211,29,177,206,5,211,https://pilkada2015.kpu.go.id/surabayakota/tandes/manukan_kulon
TPS 10,462,295,40,255,295,0,0,https://pilkada2015.kpu.go.id/surabayakota/tandes/manukan_kulon
TPS 11,637,368,60,298,358,10,368,https://pilkada2015.kpu.go.id/surabayakota/tandes/manukan_kulon
TPS 12,644,336,31,304,335,1,336,https://pilkada2015.kpu.go.id/surabayakota/tandes/manukan_kulon
TPS 13,651,401,58,337,395,6,401,https://pilkada2015.kpu.go.id/surabayakota/tandes/manukan_kulon
TPS 14,640,404,42,354,396,8,404,https://pilkada2015.kpu.go.id/surabayakota/tandes/manukan_kulon
TPS 15,509,321,43,271,314,7,321,https://pilkada2015.kpu.go.id/surabayakota/tandes/manukan_kulon
TPS 16,629,333,56,277,333,0,333,https://pilkada2015.kpu.go.id/surabayakota/tandes/manukan_kulon
TPS 17,363,216,34,180,214,2,216,https://pilkada2015.kpu.go.id/surabayakota/tandes/manukan_kulon
TPS 18,452,255,23,227,250,5,255,https://pilkada2015.kpu.go.id/surabayakota/tandes/manukan_kulon
TPS 19,445,260,44,214,258,2,260,https://pilkada2015.kpu.go.id/surabayakota/tandes/manukan_kulon
TPS 20,602,341,45,294,339,2,341,https://pilkada2015.kpu.go.id/surabayakota/tandes/manukan_kulon
TPS 21,481,239,17,219,236,3,239,https://pilkada2015.kpu.go.id/surabayakota/tandes/manukan_kulon
TPS 22,486,241,31,205,236,5,241,https://pilkada2015.kpu.go.id/surabayakota/tandes/manukan_kulon
TPS 23,625,407,63,325,388,10,398,https://pilkada2015.kpu.go.id/surabayakota/tandes/manukan_kulon
TPS 24,501,270,39,228,267,3,270,https://pilkada2015.kpu.go.id/surabayakota/tandes/manukan_kulon
TPS 25,382,195,20,172,192,3,195,https://pilkada2015.kpu.go.id/surabayakota/tandes/manukan_kulon
TPS 26,392,227,41,183,224,3,227,https://pilkada2015.kpu.go.id/surabayakota/tandes/manukan_kulon
TPS 27,550,343,67,271,338,5,343,https://pilkada2015.kpu.go.id/surabayakota/tandes/manukan_kulon
TPS 28,666,381,72,300,372,9,381,https://pilkada2015.kpu.go.id/surabayakota/tandes/manukan_kulon
TPS 29,638,385,52,328,380,5,385,https://pilkada2015.kpu.go.id/surabayakota/tandes/manukan_kulon
TPS 30,584,352,28,317,345,7,352,https://pilkada2015.kpu.go.id/surabayakota/tandes/manukan_kulon
TPS 31,451,290,42,239,281,9,290,https://pilkada2015.kpu.go.id/surabayakota/tandes/manukan_kulon
TPS 32,492,308,36,267,303,5,308,https://pilkada2015.kpu.go.id/surabayakota/tandes/manukan_kulon
TPS 33,575,369,59,301,360,9,369,https://pilkada2015.kpu.go.id/surabayakota/tandes/manukan_kulon
TPS 34,561,309,53,252,305,4,309,https://pilkada2015.kpu.go.id/surabayakota/tandes/manukan_kulon
TPS 35,534,308,32,271,303,5,308,https://pilkada2015.kpu.go.id/surabayakota/tandes/manukan_kulon
TPS 36,299,186,13,173,186,0,186,https://pilkada2015.kpu.go.id/surabayakota/tandes/manukan_kulon
TPS 37,466,330,39,285,324,6,330,https://pilkada2015.kpu.go.id/surabayakota/tandes/manukan_kulon
TPS 38,304,180,27,149,176,4,180,https://pilkada2015.kpu.go.id/surabayakota/tandes/manukan_kulon
TPS 39,550,342,37,301,338,4,342,https://pilkada2015.kpu.go.id/surabayakota/tandes/manukan_kulon
TPS 40,541,307,33,274,307,0,307,https://pilkada2015.kpu.go.id/surabayakota/tandes/manukan_kulon
TPS 41,471,289,27,258,285,4,289,https://pilkada2015.kpu.go.id/surabayakota/tandes/manukan_kulon
TPS 42,420,269,43,224,267,2,269,https://pilkada2015.kpu.go.id/surabayakota/tandes/manukan_kulon
TPS 43,453,281,49,227,276,5,281,https://pilkada2015.kpu.go.id/surabayakota/tandes/manukan_kulon
TPS 44,608,337,22,313,335,2,337,https://pilkada2015.kpu.go.id/surabayakota/tandes/manukan_kulon
TPS 45,395,239,28,200,228,11,239,https://pilkada2015.kpu.go.id/surabayakota/tandes/manukan_kulon
TPS 46,372,239,34,200,234,5,239,https://pilkada2015.kpu.go.id/surabayakota/tandes/manukan_kulon
TPS 47,483,292,34,256,290,2,292,https://pilkada2015.kpu.go.id/surabayakota/tandes/manukan_kulon
TPS 48,669,396,52,333,385,11,396,https://pilkada2015.kpu.go.id/surabayakota/tandes/manukan_kulon
TPS 49,545,297,29,263,292,5,297,https://pilkada2015.kpu.go.id/surabayakota/tandes/manukan_kulon
TPS 50,453,285,35,242,277,8,285,https://pilkada2015.kpu.go.id/surabayakota/tandes/manukan_kulon
TPS 1,494,273,39,231,270,3,273,https://pilkada2015.kpu.go.id/surabayakota/tandes/manukan_wetan
TPS 2,515,260,27,224,251,9,260,https://pilkada2015.kpu.go.id/surabayakota/tandes/manukan_wetan
TPS 3,513,301,46,250,296,5,301,https://pilkada2015.kpu.go.id/surabayakota/tandes/manukan_wetan
TPS 4,506,307,29,272,301,6,307,https://pilkada2015.kpu.go.id/surabayakota/tandes/manukan_wetan
TPS 5,548,281,29,248,277,4,281,https://pilkada2015.kpu.go.id/surabayakota/tandes/manukan_wetan
TPS 6,616,336,58,271,329,7,336,https://pilkada2015.kpu.go.id/surabayakota/tandes/manukan_wetan
TPS 7,571,393,32,357,389,4,393,https://pilkada2015.kpu.go.id/surabayakota/tandes/manukan_wetan
TPS 8,476,334,37,293,330,4,334,https://pilkada2015.kpu.go.id/surabayakota/tandes/manukan_wetan
TPS 9,517,318,38,276,314,4,318,https://pilkada2015.kpu.go.id/surabayakota/tandes/manukan_wetan
TPS 10,405,237,42,188,230,7,237,https://pilkada2015.kpu.go.id/surabayakota/tandes/manukan_wetan
TPS 11,488,330,55,266,321,9,330,https://pilkada2015.kpu.go.id/surabayakota/tandes/manukan_wetan
TPS 12,573,311,35,271,306,5,311,https://pilkada2015.kpu.go.id/surabayakota/tandes/manukan_wetan
TPS 1,676,447,55,379,434,13,447,https://pilkada2015.kpu.go.id/surabayakota/tandes/tandes
TPS 2,558,348,48,291,339,9,348,https://pilkada2015.kpu.go.id/surabayakota/tandes/tandes
TPS 3,428,274,41,225,266,8,274,https://pilkada2015.kpu.go.id/surabayakota/tandes/tandes
TPS 4,340,234,33,192,225,9,234,https://pilkada2015.kpu.go.id/surabayakota/tandes/tandes
TPS 5,502,328,40,283,323,5,328,https://pilkada2015.kpu.go.id/surabayakota/tandes/tandes
TPS 6,523,327,10,315,325,2,327,https://pilkada2015.kpu.go.id/surabayakota/tandes/tandes
TPS 7,497,243,13,228,241,2,243,https://pilkada2015.kpu.go.id/surabayakota/tandes/tandes
TPS 8,700,318,29,286,315,3,318,https://pilkada2015.kpu.go.id/surabayakota/tandes/tandes
TPS 9,439,238,24,213,237,1,238,https://pilkada2015.kpu.go.id/surabayakota/tandes/tandes
TPS 10,500,235,19,209,228,7,235,https://pilkada2015.kpu.go.id/surabayakota/tandes/tandes
TPS 11,0,476,64,409,473,3,476,https://pilkada2015.kpu.go.id/surabayakota/tandes/tandes
TPS 12,478,317,47,267,314,3,317,https://pilkada2015.kpu.go.id/surabayakota/tandes/tandes
TPS 13,391,254,8,245,253,1,254,https://pilkada2015.kpu.go.id/surabayakota/tandes/tandes
TPS 1,702,288,33,247,280,8,288,https://pilkada2015.kpu.go.id/surabayakota/tegalsari/dr._soetomo
TPS 2,699,338,46,286,332,6,338,https://pilkada2015.kpu.go.id/surabayakota/tegalsari/dr._soetomo
TPS 3,725,326,45,278,323,3,326,https://pilkada2015.kpu.go.id/surabayakota/tegalsari/dr._soetomo
TPS 4,520,181,25,151,176,5,181,https://pilkada2015.kpu.go.id/surabayakota/tegalsari/dr._soetomo
TPS 5,309,141,20,118,138,3,141,https://pilkada2015.kpu.go.id/surabayakota/tegalsari/dr._soetomo
TPS 6,620,316,68,242,310,6,316,https://pilkada2015.kpu.go.id/surabayakota/tegalsari/dr._soetomo
TPS 7,698,308,0,0,302,6,308,https://pilkada2015.kpu.go.id/surabayakota/tegalsari/dr._soetomo
TPS 8,579,260,27,229,256,4,260,https://pilkada2015.kpu.go.id/surabayakota/tegalsari/dr._soetomo
TPS 9,423,217,22,193,215,2,217,https://pilkada2015.kpu.go.id/surabayakota/tegalsari/dr._soetomo
TPS 10,471,284,43,236,279,5,284,https://pilkada2015.kpu.go.id/surabayakota/tegalsari/dr._soetomo
TPS 11,534,234,40,192,232,2,234,https://pilkada2015.kpu.go.id/surabayakota/tegalsari/dr._soetomo
TPS 12,643,272,78,291,269,3,272,https://pilkada2015.kpu.go.id/surabayakota/tegalsari/dr._soetomo
TPS 13,691,389,31,350,381,8,389,https://pilkada2015.kpu.go.id/surabayakota/tegalsari/dr._soetomo
TPS 14,662,305,37,263,300,5,305,https://pilkada2015.kpu.go.id/surabayakota/tegalsari/dr._soetomo
TPS 15,745,337,34,297,331,6,337,https://pilkada2015.kpu.go.id/surabayakota/tegalsari/dr._soetomo
TPS 16,516,250,34,208,242,8,250,https://pilkada2015.kpu.go.id/surabayakota/tegalsari/dr._soetomo
TPS 17,575,311,67,240,307,4,311,https://pilkada2015.kpu.go.id/surabayakota/tegalsari/dr._soetomo
TPS 18,635,320,46,264,310,10,320,https://pilkada2015.kpu.go.id/surabayakota/tegalsari/dr._soetomo
TPS 19,248,106,8,94,102,4,106,https://pilkada2015.kpu.go.id/surabayakota/tegalsari/dr._soetomo
TPS 20,575,186,19,165,184,2,186,https://pilkada2015.kpu.go.id/surabayakota/tegalsari/dr._soetomo
TPS 21,198,68,12,56,68,1,69,https://pilkada2015.kpu.go.id/surabayakota/tegalsari/dr._soetomo
TPS 22,337,89,14,75,89,0,89,https://pilkada2015.kpu.go.id/surabayakota/tegalsari/dr._soetomo
TPS 23,402,137,25,112,137,0,137,https://pilkada2015.kpu.go.id/surabayakota/tegalsari/dr._soetomo
TPS 24,363,106,17,88,105,1,106,https://pilkada2015.kpu.go.id/surabayakota/tegalsari/dr._soetomo
TPS 25,689,245,29,215,244,1,245,https://pilkada2015.kpu.go.id/surabayakota/tegalsari/dr._soetomo
TPS 1,256,80,4,76,80,0,80,https://pilkada2015.kpu.go.id/surabayakota/tegalsari/kedungdoro
TPS 2,567,310,41,264,305,5,310,https://pilkada2015.kpu.go.id/surabayakota/tegalsari/kedungdoro
TPS 3,512,241,25,210,235,6,241,https://pilkada2015.kpu.go.id/surabayakota/tegalsari/kedungdoro
TPS 4,513,235,13,220,233,2,235,https://pilkada2015.kpu.go.id/surabayakota/tegalsari/kedungdoro
TPS 5,630,283,35,240,275,8,283,https://pilkada2015.kpu.go.id/surabayakota/tegalsari/kedungdoro
TPS 6,604,280,27,251,278,2,280,https://pilkada2015.kpu.go.id/surabayakota/tegalsari/kedungdoro
TPS 7,553,262,37,221,258,4,262,https://pilkada2015.kpu.go.id/surabayakota/tegalsari/kedungdoro
TPS 8,465,215,30,185,215,0,215,https://pilkada2015.kpu.go.id/surabayakota/tegalsari/kedungdoro
TPS 9,694,318,47,264,311,7,318,https://pilkada2015.kpu.go.id/surabayakota/tegalsari/kedungdoro
TPS 10,495,186,28,157,185,1,186,https://pilkada2015.kpu.go.id/surabayakota/tegalsari/kedungdoro
TPS 11,618,272,41,228,269,3,272,https://pilkada2015.kpu.go.id/surabayakota/tegalsari/kedungdoro
TPS 12,479,225,21,200,221,4,225,https://pilkada2015.kpu.go.id/surabayakota/tegalsari/kedungdoro
TPS 13,515,271,20,244,264,7,271,https://pilkada2015.kpu.go.id/surabayakota/tegalsari/kedungdoro
TPS 14,703,288,46,236,282,6,288,https://pilkada2015.kpu.go.id/surabayakota/tegalsari/kedungdoro
TPS 15,698,273,34,234,268,5,273,https://pilkada2015.kpu.go.id/surabayakota/tegalsari/kedungdoro
TPS 16,472,177,21,155,176,1,177,https://pilkada2015.kpu.go.id/surabayakota/tegalsari/kedungdoro
TPS 17,480,195,20,170,190,5,195,https://pilkada2015.kpu.go.id/surabayakota/tegalsari/kedungdoro
TPS 18,483,233,28,202,230,3,233,https://pilkada2015.kpu.go.id/surabayakota/tegalsari/kedungdoro
TPS 19,631,241,36,200,236,5,241,https://pilkada2015.kpu.go.id/surabayakota/tegalsari/kedungdoro
TPS 20,548,277,37,237,274,3,277,https://pilkada2015.kpu.go.id/surabayakota/tegalsari/kedungdoro
TPS 21,574,224,31,190,221,3,224,https://pilkada2015.kpu.go.id/surabayakota/tegalsari/kedungdoro
TPS 22,528,220,23,196,119,1,220,https://pilkada2015.kpu.go.id/surabayakota/tegalsari/kedungdoro
TPS 23,616,253,34,215,249,4,253,https://pilkada2015.kpu.go.id/surabayakota/tegalsari/kedungdoro
TPS 24,762,263,21,240,261,2,263,https://pilkada2015.kpu.go.id/surabayakota/tegalsari/kedungdoro
TPS 25,620,275,31,244,275,0,275,https://pilkada2015.kpu.go.id/surabayakota/tegalsari/kedungdoro
TPS 26,766,327,39,279,318,9,327,https://pilkada2015.kpu.go.id/surabayakota/tegalsari/kedungdoro
TPS 27,533,183,14,168,182,1,183,https://pilkada2015.kpu.go.id/surabayakota/tegalsari/kedungdoro
TPS 28,430,214,21,190,211,3,214,https://pilkada2015.kpu.go.id/surabayakota/tegalsari/kedungdoro
TPS 29,575,288,27,256,283,5,288,https://pilkada2015.kpu.go.id/surabayakota/tegalsari/kedungdoro
TPS 30,404,143,17,123,140,3,143,https://pilkada2015.kpu.go.id/surabayakota/tegalsari/kedungdoro
TPS 31,656,292,30,260,290,2,292,https://pilkada2015.kpu.go.id/surabayakota/tegalsari/kedungdoro
TPS 32,559,186,25,158,183,3,186,https://pilkada2015.kpu.go.id/surabayakota/tegalsari/kedungdoro
TPS 33,525,188,13,173,186,2,188,https://pilkada2015.kpu.go.id/surabayakota/tegalsari/kedungdoro
TPS 34,504,196,19,174,194,2,196,https://pilkada2015.kpu.go.id/surabayakota/tegalsari/kedungdoro
TPS 35,635,243,30,210,240,3,243,https://pilkada2015.kpu.go.id/surabayakota/tegalsari/kedungdoro
TPS 1,587,264,33,227,260,4,264,https://pilkada2015.kpu.go.id/surabayakota/tegalsari/keputran
TPS 2,631,225,32,190,222,3,225,https://pilkada2015.kpu.go.id/surabayakota/tegalsari/keputran
TPS 3,584,175,16,155,171,4,175,https://pilkada2015.kpu.go.id/surabayakota/tegalsari/keputran
TPS 4,377,159,14,144,158,1,159,https://pilkada2015.kpu.go.id/surabayakota/tegalsari/keputran
TPS 5,525,192,13,178,191,1,192,https://pilkada2015.kpu.go.id/surabayakota/tegalsari/keputran
TPS 6,454,193,19,172,191,2,193,https://pilkada2015.kpu.go.id/surabayakota/tegalsari/keputran
TPS 7,563,310,27,276,303,7,310,https://pilkada2015.kpu.go.id/surabayakota/tegalsari/keputran
TPS 8,305,604,38,262,300,5,305,https://pilkada2015.kpu.go.id/surabayakota/tegalsari/keputran
TPS 9,612,338,22,315,337,1,338,https://pilkada2015.kpu.go.id/surabayakota/tegalsari/keputran
TPS 10,510,303,33,262,295,8,303,https://pilkada2015.kpu.go.id/surabayakota/tegalsari/keputran
TPS 11,0,0,32,237,0,0,0,https://pilkada2015.kpu.go.id/surabayakota/tegalsari/keputran
TPS 12,430,197,22,173,195,2,197,https://pilkada2015.kpu.go.id/surabayakota/tegalsari/keputran
TPS 13,475,279,40,238,278,1,279,https://pilkada2015.kpu.go.id/surabayakota/tegalsari/keputran
TPS 14,465,264,34,226,260,4,264,https://pilkada2015.kpu.go.id/surabayakota/tegalsari/keputran
TPS 15,570,323,26,283,309,6,315,https://pilkada2015.kpu.go.id/surabayakota/tegalsari/keputran
TPS 16,574,319,35,272,307,12,319,https://pilkada2015.kpu.go.id/surabayakota/tegalsari/keputran
TPS 17,552,243,42,196,238,5,243,https://pilkada2015.kpu.go.id/surabayakota/tegalsari/keputran
TPS 18,0,275,39,233,272,3,275,https://pilkada2015.kpu.go.id/surabayakota/tegalsari/keputran
TPS 19,538,264,47,212,259,5,264,https://pilkada2015.kpu.go.id/surabayakota/tegalsari/keputran
TPS 20,488,219,32,183,215,4,219,https://pilkada2015.kpu.go.id/surabayakota/tegalsari/keputran
TPS 21,529,244,29,210,239,5,244,https://pilkada2015.kpu.go.id/surabayakota/tegalsari/keputran
TPS 22,616,234,30,199,229,5,234,https://pilkada2015.kpu.go.id/surabayakota/tegalsari/keputran
TPS 23,604,264,31,225,256,8,264,https://pilkada2015.kpu.go.id/surabayakota/tegalsari/keputran
TPS 1,578,161,9,149,158,3,161,https://pilkada2015.kpu.go.id/surabayakota/tegalsari/tegalsari
TPS 2,597,244,22,214,236,8,244,https://pilkada2015.kpu.go.id/surabayakota/tegalsari/tegalsari
TPS 3,610,293,34,254,288,5,293,https://pilkada2015.kpu.go.id/surabayakota/tegalsari/tegalsari
TPS 4,554,294,39,250,289,5,294,https://pilkada2015.kpu.go.id/surabayakota/tegalsari/tegalsari
TPS 5,552,277,54,218,272,5,277,https://pilkada2015.kpu.go.id/surabayakota/tegalsari/tegalsari
TPS 6,482,239,33,201,234,5,239,https://pilkada2015.kpu.go.id/surabayakota/tegalsari/tegalsari
TPS 7,481,209,27,179,206,3,209,https://pilkada2015.kpu.go.id/surabayakota/tegalsari/tegalsari
TPS 8,489,220,30,183,213,7,220,https://pilkada2015.kpu.go.id/surabayakota/tegalsari/tegalsari
TPS 9,535,218,37,177,214,4,218,https://pilkada2015.kpu.go.id/surabayakota/tegalsari/tegalsari
TPS 10,517,216,22,191,213,3,216,https://pilkada2015.kpu.go.id/surabayakota/tegalsari/tegalsari
TPS 11,660,294,67,221,288,6,294,https://pilkada2015.kpu.go.id/surabayakota/tegalsari/tegalsari
TPS 12,593,256,19,232,251,5,256,https://pilkada2015.kpu.go.id/surabayakota/tegalsari/tegalsari
TPS 13,580,331,42,282,324,7,331,https://pilkada2015.kpu.go.id/surabayakota/tegalsari/tegalsari
TPS 14,544,273,39,223,262,11,273,https://pilkada2015.kpu.go.id/surabayakota/tegalsari/tegalsari
TPS 15,510,270,25,241,266,4,270,https://pilkada2015.kpu.go.id/surabayakota/tegalsari/tegalsari
TPS 16,534,212,23,187,0,0,0,https://pilkada2015.kpu.go.id/surabayakota/tegalsari/tegalsari
TPS 17,219,219,30,186,216,3,219,https://pilkada2015.kpu.go.id/surabayakota/tegalsari/tegalsari
TPS 18,541,258,18,238,256,2,258,https://pilkada2015.kpu.go.id/surabayakota/tegalsari/tegalsari
TPS 19,546,250,21,225,246,4,250,https://pilkada2015.kpu.go.id/surabayakota/tegalsari/tegalsari
TPS 20,514,246,34,209,243,3,246,https://pilkada2015.kpu.go.id/surabayakota/tegalsari/tegalsari
TPS 21,640,223,42,176,218,5,223,https://pilkada2015.kpu.go.id/surabayakota/tegalsari/tegalsari
TPS 22,650,250,32,214,246,4,250,https://pilkada2015.kpu.go.id/surabayakota/tegalsari/tegalsari
TPS 23,644,282,41,235,276,6,282,https://pilkada2015.kpu.go.id/surabayakota/tegalsari/tegalsari
TPS 24,557,279,30,248,278,1,279,https://pilkada2015.kpu.go.id/surabayakota/tegalsari/tegalsari
TPS 25,552,261,42,213,255,6,261,https://pilkada2015.kpu.go.id/surabayakota/tegalsari/tegalsari
TPS 26,613,304,47,252,299,5,304,https://pilkada2015.kpu.go.id/surabayakota/tegalsari/tegalsari
TPS 1,483,180,14,166,180,0,180,https://pilkada2015.kpu.go.id/surabayakota/tegalsari/wonorejo
TPS 2,501,222,30,186,216,6,222,https://pilkada2015.kpu.go.id/surabayakota/tegalsari/wonorejo
TPS 3,556,275,30,239,269,6,275,https://pilkada2015.kpu.go.id/surabayakota/tegalsari/wonorejo
TPS 4,545,260,27,229,256,4,260,https://pilkada2015.kpu.go.id/surabayakota/tegalsari/wonorejo
TPS 5,592,318,44,268,312,6,318,https://pilkada2015.kpu.go.id/surabayakota/tegalsari/wonorejo
TPS 6,570,272,26,242,268,4,272,https://pilkada2015.kpu.go.id/surabayakota/tegalsari/wonorejo
TPS 7,581,246,31,208,239,7,246,https://pilkada2015.kpu.go.id/surabayakota/tegalsari/wonorejo
TPS 8,582,282,25,254,279,3,282,https://pilkada2015.kpu.go.id/surabayakota/tegalsari/wonorejo
TPS 9,556,207,24,180,204,3,207,https://pilkada2015.kpu.go.id/surabayakota/tegalsari/wonorejo
TPS 10,553,249,35,209,244,5,249,https://pilkada2015.kpu.go.id/surabayakota/tegalsari/wonorejo
TPS 11,550,214,14,196,210,4,214,https://pilkada2015.kpu.go.id/surabayakota/tegalsari/wonorejo
TPS 12,558,162,30,132,162,1,163,https://pilkada2015.kpu.go.id/surabayakota/tegalsari/wonorejo
TPS 13,546,205,28,174,202,3,205,https://pilkada2015.kpu.go.id/surabayakota/tegalsari/wonorejo
TPS 14,559,212,22,189,211,1,212,https://pilkada2015.kpu.go.id/surabayakota/tegalsari/wonorejo
TPS 15,549,215,35,179,214,1,215,https://pilkada2015.kpu.go.id/surabayakota/tegalsari/wonorejo
TPS 16,545,189,20,168,188,1,189,https://pilkada2015.kpu.go.id/surabayakota/tegalsari/wonorejo
TPS 17,552,196,31,162,193,3,196,https://pilkada2015.kpu.go.id/surabayakota/tegalsari/wonorejo
TPS 18,607,243,35,208,243,0,243,https://pilkada2015.kpu.go.id/surabayakota/tegalsari/wonorejo
TPS 19,622,280,44,230,274,6,280,https://pilkada2015.kpu.go.id/surabayakota/tegalsari/wonorejo
TPS 20,616,268,30,236,266,2,268,https://pilkada2015.kpu.go.id/surabayakota/tegalsari/wonorejo
TPS 21,636,226,28,190,218,8,226,https://pilkada2015.kpu.go.id/surabayakota/tegalsari/wonorejo
TPS 22,620,205,42,158,200,5,205,https://pilkada2015.kpu.go.id/surabayakota/tegalsari/wonorejo
TPS 23,613,271,53,213,266,5,271,https://pilkada2015.kpu.go.id/surabayakota/tegalsari/wonorejo
TPS 24,620,229,26,198,224,5,229,https://pilkada2015.kpu.go.id/surabayakota/tegalsari/wonorejo
TPS 25,455,230,29,197,226,4,230,https://pilkada2015.kpu.go.id/surabayakota/tegalsari/wonorejo
TPS 26,473,244,40,199,239,5,244,https://pilkada2015.kpu.go.id/surabayakota/tegalsari/wonorejo
TPS 27,469,200,31,167,198,2,200,https://pilkada2015.kpu.go.id/surabayakota/tegalsari/wonorejo
TPS 28,636,248,24,221,245,3,248,https://pilkada2015.kpu.go.id/surabayakota/tegalsari/wonorejo
TPS 29,647,270,34,232,266,4,270,https://pilkada2015.kpu.go.id/surabayakota/tegalsari/wonorejo
TPS 30,649,231,48,176,224,7,231,https://pilkada2015.kpu.go.id/surabayakota/tegalsari/wonorejo
TPS 31,354,132,20,111,131,1,132,https://pilkada2015.kpu.go.id/surabayakota/tegalsari/wonorejo
TPS 32,605,207,28,174,410,5,207,https://pilkada2015.kpu.go.id/surabayakota/tegalsari/wonorejo
TPS 33,611,215,21,192,213,2,215,https://pilkada2015.kpu.go.id/surabayakota/tegalsari/wonorejo
TPS 34,614,273,44,226,270,3,273,https://pilkada2015.kpu.go.id/surabayakota/tegalsari/wonorejo
TPS 35,647,264,33,230,263,1,264,https://pilkada2015.kpu.go.id/surabayakota/tegalsari/wonorejo
TPS 36,515,241,25,214,239,2,241,https://pilkada2015.kpu.go.id/surabayakota/tegalsari/wonorejo
TPS 37,504,213,29,181,210,3,213,https://pilkada2015.kpu.go.id/surabayakota/tegalsari/wonorejo
TPS 38,504,200,29,168,197,3,200,https://pilkada2015.kpu.go.id/surabayakota/tegalsari/wonorejo
TPS 39,502,253,47,196,243,10,253,https://pilkada2015.kpu.go.id/surabayakota/tegalsari/wonorejo
TPS 40,478,210,28,180,208,2,210,https://pilkada2015.kpu.go.id/surabayakota/tegalsari/wonorejo
TPS 1,667,260,21,238,259,1,260,https://pilkada2015.kpu.go.id/surabayakota/tenggilis_mejoyo/kendangsari
TPS 2,461,212,22,188,210,2,212,https://pilkada2015.kpu.go.id/surabayakota/tenggilis_mejoyo/kendangsari
TPS 3,452,170,9,155,164,6,170,https://pilkada2015.kpu.go.id/surabayakota/tenggilis_mejoyo/kendangsari
TPS 4,455,198,12,182,194,4,198,https://pilkada2015.kpu.go.id/surabayakota/tenggilis_mejoyo/kendangsari
TPS 5,485,286,32,248,280,6,286,https://pilkada2015.kpu.go.id/surabayakota/tenggilis_mejoyo/kendangsari
TPS 6,569,308,35,268,303,5,308,https://pilkada2015.kpu.go.id/surabayakota/tenggilis_mejoyo/kendangsari
TPS 7,617,302,43,257,300,2,302,https://pilkada2015.kpu.go.id/surabayakota/tenggilis_mejoyo/kendangsari
TPS 8,536,292,33,255,288,4,292,https://pilkada2015.kpu.go.id/surabayakota/tenggilis_mejoyo/kendangsari
TPS 9,565,293,33,255,288,5,293,https://pilkada2015.kpu.go.id/surabayakota/tenggilis_mejoyo/kendangsari
TPS 10,660,345,34,307,341,4,345,https://pilkada2015.kpu.go.id/surabayakota/tenggilis_mejoyo/kendangsari
TPS 11,586,283,46,231,277,6,283,https://pilkada2015.kpu.go.id/surabayakota/tenggilis_mejoyo/kendangsari
TPS 12,628,312,32,279,311,1,312,https://pilkada2015.kpu.go.id/surabayakota/tenggilis_mejoyo/kendangsari
TPS 13,585,277,28,246,274,3,277,https://pilkada2015.kpu.go.id/surabayakota/tenggilis_mejoyo/kendangsari
TPS 14,588,363,41,318,359,4,363,https://pilkada2015.kpu.go.id/surabayakota/tenggilis_mejoyo/kendangsari
TPS 15,583,340,14,322,336,4,340,https://pilkada2015.kpu.go.id/surabayakota/tenggilis_mejoyo/kendangsari
TPS 16,588,344,35,305,340,4,344,https://pilkada2015.kpu.go.id/surabayakota/tenggilis_mejoyo/kendangsari
TPS 17,548,320,32,284,316,4,320,https://pilkada2015.kpu.go.id/surabayakota/tenggilis_mejoyo/kendangsari
TPS 18,532,294,40,251,291,3,294,https://pilkada2015.kpu.go.id/surabayakota/tenggilis_mejoyo/kendangsari
TPS 19,544,310,30,275,305,5,310,https://pilkada2015.kpu.go.id/surabayakota/tenggilis_mejoyo/kendangsari
TPS 20,539,308,26,280,306,2,308,https://pilkada2015.kpu.go.id/surabayakota/tenggilis_mejoyo/kendangsari
TPS 1,714,379,79,293,372,7,379,https://pilkada2015.kpu.go.id/surabayakota/tenggilis_mejoyo/kutisari
TPS 2,485,281,44,232,276,5,281,https://pilkada2015.kpu.go.id/surabayakota/tenggilis_mejoyo/kutisari
TPS 3,434,253,28,219,247,6,253,https://pilkada2015.kpu.go.id/surabayakota/tenggilis_mejoyo/kutisari
TPS 4,563,323,46,268,314,9,323,https://pilkada2015.kpu.go.id/surabayakota/tenggilis_mejoyo/kutisari
TPS 5,508,303,37,261,298,5,303,https://pilkada2015.kpu.go.id/surabayakota/tenggilis_mejoyo/kutisari
TPS 6,423,204,32,165,197,7,204,https://pilkada2015.kpu.go.id/surabayakota/tenggilis_mejoyo/kutisari
TPS 7,532,237,39,196,235,2,237,https://pilkada2015.kpu.go.id/surabayakota/tenggilis_mejoyo/kutisari
TPS 8,385,239,32,201,233,6,239,https://pilkada2015.kpu.go.id/surabayakota/tenggilis_mejoyo/kutisari
TPS 9,538,355,49,300,349,6,355,https://pilkada2015.kpu.go.id/surabayakota/tenggilis_mejoyo/kutisari
TPS 10,423,276,31,241,272,4,276,https://pilkada2015.kpu.go.id/surabayakota/tenggilis_mejoyo/kutisari
TPS 11,377,204,21,182,203,1,204,https://pilkada2015.kpu.go.id/surabayakota/tenggilis_mejoyo/kutisari
TPS 12,624,363,46,314,360,3,363,https://pilkada2015.kpu.go.id/surabayakota/tenggilis_mejoyo/kutisari
TPS 13,523,263,29,230,259,4,263,https://pilkada2015.kpu.go.id/surabayakota/tenggilis_mejoyo/kutisari
TPS 14,0,340,25,312,337,3,340,https://pilkada2015.kpu.go.id/surabayakota/tenggilis_mejoyo/kutisari
TPS 15,604,347,40,304,344,3,347,https://pilkada2015.kpu.go.id/surabayakota/tenggilis_mejoyo/kutisari
TPS 16,658,392,66,320,386,6,392,https://pilkada2015.kpu.go.id/surabayakota/tenggilis_mejoyo/kutisari
TPS 17,540,297,29,262,291,6,297,https://pilkada2015.kpu.go.id/surabayakota/tenggilis_mejoyo/kutisari
TPS 18,699,407,24,381,405,2,407,https://pilkada2015.kpu.go.id/surabayakota/tenggilis_mejoyo/kutisari
TPS 19,516,324,24,299,323,1,324,https://pilkada2015.kpu.go.id/surabayakota/tenggilis_mejoyo/kutisari
TPS 20,466,293,28,263,291,2,293,https://pilkada2015.kpu.go.id/surabayakota/tenggilis_mejoyo/kutisari
TPS 21,445,281,8,269,277,4,281,https://pilkada2015.kpu.go.id/surabayakota/tenggilis_mejoyo/kutisari
TPS 22,555,321,14,304,318,3,321,https://pilkada2015.kpu.go.id/surabayakota/tenggilis_mejoyo/kutisari
TPS 23,707,406,21,383,404,2,406,https://pilkada2015.kpu.go.id/surabayakota/tenggilis_mejoyo/kutisari
TPS 24,602,335,18,315,333,2,335,https://pilkada2015.kpu.go.id/surabayakota/tenggilis_mejoyo/kutisari
TPS 1,472,265,24,239,263,2,265,https://pilkada2015.kpu.go.id/surabayakota/tenggilis_mejoyo/panjang_jiwo
TPS 2,422,259,29,226,255,4,259,https://pilkada2015.kpu.go.id/surabayakota/tenggilis_mejoyo/panjang_jiwo
TPS 3,494,284,24,255,279,5,284,https://pilkada2015.kpu.go.id/surabayakota/tenggilis_mejoyo/panjang_jiwo
TPS 4,505,208,44,161,205,3,208,https://pilkada2015.kpu.go.id/surabayakota/tenggilis_mejoyo/panjang_jiwo
TPS 5,489,225,34,183,217,8,225,https://pilkada2015.kpu.go.id/surabayakota/tenggilis_mejoyo/panjang_jiwo
TPS 6,499,260,28,232,260,0,260,https://pilkada2015.kpu.go.id/surabayakota/tenggilis_mejoyo/panjang_jiwo
TPS 7,469,274,29,239,268,6,274,https://pilkada2015.kpu.go.id/surabayakota/tenggilis_mejoyo/panjang_jiwo
TPS 8,470,281,23,255,278,3,281,https://pilkada2015.kpu.go.id/surabayakota/tenggilis_mejoyo/panjang_jiwo
TPS 9,521,316,34,276,310,6,316,https://pilkada2015.kpu.go.id/surabayakota/tenggilis_mejoyo/panjang_jiwo
TPS 10,548,309,51,254,305,4,309,https://pilkada2015.kpu.go.id/surabayakota/tenggilis_mejoyo/panjang_jiwo
TPS 11,622,338,40,293,333,5,338,https://pilkada2015.kpu.go.id/surabayakota/tenggilis_mejoyo/panjang_jiwo
TPS 12,599,362,36,317,353,9,362,https://pilkada2015.kpu.go.id/surabayakota/tenggilis_mejoyo/panjang_jiwo
TPS 13,777,261,12,243,255,6,261,https://pilkada2015.kpu.go.id/surabayakota/tenggilis_mejoyo/panjang_jiwo
TPS 14,533,271,43,220,263,8,271,https://pilkada2015.kpu.go.id/surabayakota/tenggilis_mejoyo/panjang_jiwo
TPS 15,526,267,31,228,259,8,267,https://pilkada2015.kpu.go.id/surabayakota/tenggilis_mejoyo/panjang_jiwo
TPS 16,727,332,20,308,328,4,332,https://pilkada2015.kpu.go.id/surabayakota/tenggilis_mejoyo/panjang_jiwo
TPS 17,352,185,9,175,184,1,185,https://pilkada2015.kpu.go.id/surabayakota/tenggilis_mejoyo/panjang_jiwo
TPS 1,454,222,21,196,217,5,222,https://pilkada2015.kpu.go.id/surabayakota/tenggilis_mejoyo/tengilis_mejoyo
TPS 2,0,273,49,221,270,3,273,https://pilkada2015.kpu.go.id/surabayakota/tenggilis_mejoyo/tengilis_mejoyo
TPS 3,592,328,29,298,327,1,328,https://pilkada2015.kpu.go.id/surabayakota/tenggilis_mejoyo/tengilis_mejoyo
TPS 4,558,267,30,231,261,6,267,https://pilkada2015.kpu.go.id/surabayakota/tenggilis_mejoyo/tengilis_mejoyo
TPS 5,673,315,38,271,309,6,315,https://pilkada2015.kpu.go.id/surabayakota/tenggilis_mejoyo/tengilis_mejoyo
TPS 6,429,222,14,208,222,0,222,https://pilkada2015.kpu.go.id/surabayakota/tenggilis_mejoyo/tengilis_mejoyo
TPS 7,615,317,26,286,312,5,317,https://pilkada2015.kpu.go.id/surabayakota/tenggilis_mejoyo/tengilis_mejoyo
TPS 8,304,193,35,154,189,4,193,https://pilkada2015.kpu.go.id/surabayakota/tenggilis_mejoyo/tengilis_mejoyo
TPS 9,734,353,46,299,345,8,353,https://pilkada2015.kpu.go.id/surabayakota/tenggilis_mejoyo/tengilis_mejoyo
TPS 10,691,372,34,330,364,7,371,https://pilkada2015.kpu.go.id/surabayakota/tenggilis_mejoyo/tengilis_mejoyo
TPS 11,448,232,32,196,228,4,232,https://pilkada2015.kpu.go.id/surabayakota/tenggilis_mejoyo/tengilis_mejoyo
TPS 12,530,312,37,271,308,4,312,https://pilkada2015.kpu.go.id/surabayakota/tenggilis_mejoyo/tengilis_mejoyo
TPS 13,638,363,23,331,354,9,363,https://pilkada2015.kpu.go.id/surabayakota/tenggilis_mejoyo/tengilis_mejoyo
TPS 14,658,340,0,0,333,7,340,https://pilkada2015.kpu.go.id/surabayakota/tenggilis_mejoyo/tengilis_mejoyo
TPS 1,721,385,34,342,376,9,385,https://pilkada2015.kpu.go.id/surabayakota/wiyung/babatan
TPS 2,762,387,28,350,378,9,387,https://pilkada2015.kpu.go.id/surabayakota/wiyung/babatan
TPS 3,767,370,28,333,361,9,370,https://pilkada2015.kpu.go.id/surabayakota/wiyung/babatan
TPS 4,719,406,34,358,392,14,406,https://pilkada2015.kpu.go.id/surabayakota/wiyung/babatan
TPS 5,419,268,35,224,259,9,268,https://pilkada2015.kpu.go.id/surabayakota/wiyung/babatan
TPS 6,681,333,35,295,330,3,333,https://pilkada2015.kpu.go.id/surabayakota/wiyung/babatan
TPS 7,410,258,20,235,255,3,258,https://pilkada2015.kpu.go.id/surabayakota/wiyung/babatan
TPS 8,368,219,26,185,211,8,219,https://pilkada2015.kpu.go.id/surabayakota/wiyung/babatan
TPS 9,564,312,46,254,300,12,312,https://pilkada2015.kpu.go.id/surabayakota/wiyung/babatan
TPS 10,599,305,28,275,303,2,305,https://pilkada2015.kpu.go.id/surabayakota/wiyung/babatan
TPS 11,558,274,32,236,268,6,274,https://pilkada2015.kpu.go.id/surabayakota/wiyung/babatan
TPS 12,392,242,24,213,237,5,242,https://pilkada2015.kpu.go.id/surabayakota/wiyung/babatan
TPS 13,492,253,35,214,249,4,253,https://pilkada2015.kpu.go.id/surabayakota/wiyung/babatan
TPS 14,530,291,52,234,286,5,291,https://pilkada2015.kpu.go.id/surabayakota/wiyung/babatan
TPS 15,467,227,22,202,224,3,227,https://pilkada2015.kpu.go.id/surabayakota/wiyung/babatan
TPS 16,452,208,28,176,204,4,208,https://pilkada2015.kpu.go.id/surabayakota/wiyung/babatan
TPS 17,518,286,33,250,283,3,286,https://pilkada2015.kpu.go.id/surabayakota/wiyung/babatan
TPS 18,480,283,38,244,282,1,283,https://pilkada2015.kpu.go.id/surabayakota/wiyung/babatan
TPS 19,739,258,22,232,254,4,258,https://pilkada2015.kpu.go.id/surabayakota/wiyung/babatan
TPS 20,804,366,75,286,361,5,366,https://pilkada2015.kpu.go.id/surabayakota/wiyung/babatan
TPS 21,784,353,54,294,348,5,353,https://pilkada2015.kpu.go.id/surabayakota/wiyung/babatan
TPS 22,525,287,30,254,284,3,287,https://pilkada2015.kpu.go.id/surabayakota/wiyung/babatan
TPS 23,510,281,30,245,275,6,281,https://pilkada2015.kpu.go.id/surabayakota/wiyung/babatan
TPS 24,806,377,17,359,376,1,377,https://pilkada2015.kpu.go.id/surabayakota/wiyung/babatan
TPS 25,509,193,13,180,193,0,193,https://pilkada2015.kpu.go.id/surabayakota/wiyung/babatan
TPS 26,712,356,34,320,354,2,356,https://pilkada2015.kpu.go.id/surabayakota/wiyung/babatan
TPS 27,708,310,17,292,309,1,310,https://pilkada2015.kpu.go.id/surabayakota/wiyung/babatan
TPS 28,381,176,11,165,176,0,176,https://pilkada2015.kpu.go.id/surabayakota/wiyung/babatan
TPS 29,618,265,25,239,264,1,265,https://pilkada2015.kpu.go.id/surabayakota/wiyung/babatan
TPS 30,537,218,20,195,215,3,218,https://pilkada2015.kpu.go.id/surabayakota/wiyung/babatan
TPS 31,322,130,12,116,128,2,130,https://pilkada2015.kpu.go.id/surabayakota/wiyung/babatan
TPS 32,632,283,16,265,281,2,283,https://pilkada2015.kpu.go.id/surabayakota/wiyung/babatan
TPS 33,732,214,17,196,213,1,214,https://pilkada2015.kpu.go.id/surabayakota/wiyung/babatan
TPS 34,377,174,9,164,173,1,174,https://pilkada2015.kpu.go.id/surabayakota/wiyung/babatan
TPS 35,462,139,10,127,137,2,139,https://pilkada2015.kpu.go.id/surabayakota/wiyung/babatan
TPS 1,619,381,52,315,367,14,381,https://pilkada2015.kpu.go.id/surabayakota/wiyung/balas_klumprik
TPS 2,597,316,36,269,305,11,316,https://pilkada2015.kpu.go.id/surabayakota/wiyung/balas_klumprik
TPS 3,628,386,55,318,373,13,386,https://pilkada2015.kpu.go.id/surabayakota/wiyung/balas_klumprik
TPS 4,627,366,49,306,355,11,366,https://pilkada2015.kpu.go.id/surabayakota/wiyung/balas_klumprik
TPS 5,571,269,40,223,263,6,269,https://pilkada2015.kpu.go.id/surabayakota/wiyung/balas_klumprik
TPS 6,493,273,43,222,265,8,273,https://pilkada2015.kpu.go.id/surabayakota/wiyung/balas_klumprik
TPS 7,655,436,49,380,429,7,436,https://pilkada2015.kpu.go.id/surabayakota/wiyung/balas_klumprik
TPS 8,558,305,33,267,300,5,305,https://pilkada2015.kpu.go.id/surabayakota/wiyung/balas_klumprik
TPS 9,444,252,24,225,249,3,252,https://pilkada2015.kpu.go.id/surabayakota/wiyung/balas_klumprik
TPS 10,519,312,30,276,306,6,312,https://pilkada2015.kpu.go.id/surabayakota/wiyung/balas_klumprik
TPS 11,398,239,29,208,237,2,239,https://pilkada2015.kpu.go.id/surabayakota/wiyung/balas_klumprik
TPS 12,659,368,50,314,364,4,368,https://pilkada2015.kpu.go.id/surabayakota/wiyung/balas_klumprik
TPS 13,403,262,26,231,257,5,262,https://pilkada2015.kpu.go.id/surabayakota/wiyung/balas_klumprik
TPS 14,428,282,40,240,280,2,282,https://pilkada2015.kpu.go.id/surabayakota/wiyung/balas_klumprik
TPS 15,457,292,50,237,287,5,292,https://pilkada2015.kpu.go.id/surabayakota/wiyung/balas_klumprik
TPS 16,524,264,29,234,263,1,264,https://pilkada2015.kpu.go.id/surabayakota/wiyung/balas_klumprik
TPS 1,696,428,26,397,423,5,428,https://pilkada2015.kpu.go.id/surabayakota/wiyung/jajar_tunggal
TPS 2,632,370,40,326,366,4,370,https://pilkada2015.kpu.go.id/surabayakota/wiyung/jajar_tunggal
TPS 3,654,325,31,293,324,1,325,https://pilkada2015.kpu.go.id/surabayakota/wiyung/jajar_tunggal
TPS 4,632,383,34,332,366,17,383,https://pilkada2015.kpu.go.id/surabayakota/wiyung/jajar_tunggal
TPS 5,519,229,24,202,226,3,229,https://pilkada2015.kpu.go.id/surabayakota/wiyung/jajar_tunggal
TPS 6,537,265,27,229,256,9,265,https://pilkada2015.kpu.go.id/surabayakota/wiyung/jajar_tunggal
TPS 7,488,236,30,204,234,2,236,https://pilkada2015.kpu.go.id/surabayakota/wiyung/jajar_tunggal
TPS 8,489,303,24,266,290,13,303,https://pilkada2015.kpu.go.id/surabayakota/wiyung/jajar_tunggal
TPS 9,452,279,15,257,272,7,279,https://pilkada2015.kpu.go.id/surabayakota/wiyung/jajar_tunggal
TPS 10,465,265,47,215,262,3,265,https://pilkada2015.kpu.go.id/surabayakota/wiyung/jajar_tunggal
TPS 11,513,241,70,164,234,7,241,https://pilkada2015.kpu.go.id/surabayakota/wiyung/jajar_tunggal
TPS 12,474,249,29,214,243,6,249,https://pilkada2015.kpu.go.id/surabayakota/wiyung/jajar_tunggal
TPS 13,478,251,27,223,250,1,251,https://pilkada2015.kpu.go.id/surabayakota/wiyung/jajar_tunggal
TPS 14,671,335,23,312,335,0,335,https://pilkada2015.kpu.go.id/surabayakota/wiyung/jajar_tunggal
TPS 1,755,468,40,423,463,5,468,https://pilkada2015.kpu.go.id/surabayakota/wiyung/wiyung
TPS 2,664,406,41,357,398,8,406,https://pilkada2015.kpu.go.id/surabayakota/wiyung/wiyung
TPS 3,674,360,50,304,354,6,360,https://pilkada2015.kpu.go.id/surabayakota/wiyung/wiyung
TPS 4,640,405,46,353,399,6,405,https://pilkada2015.kpu.go.id/surabayakota/wiyung/wiyung
TPS 5,625,391,36,350,386,5,391,https://pilkada2015.kpu.go.id/surabayakota/wiyung/wiyung
TPS 6,671,393,34,347,381,12,393,https://pilkada2015.kpu.go.id/surabayakota/wiyung/wiyung
TPS 7,572,388,27,353,380,8,388,https://pilkada2015.kpu.go.id/surabayakota/wiyung/wiyung
TPS 8,588,372,24,344,368,4,372,https://pilkada2015.kpu.go.id/surabayakota/wiyung/wiyung
TPS 9,483,250,33,213,246,4,250,https://pilkada2015.kpu.go.id/surabayakota/wiyung/wiyung
TPS 10,501,262,25,234,259,3,262,https://pilkada2015.kpu.go.id/surabayakota/wiyung/wiyung
TPS 11,486,234,39,190,229,5,234,https://pilkada2015.kpu.go.id/surabayakota/wiyung/wiyung
TPS 12,469,241,39,197,236,5,241,https://pilkada2015.kpu.go.id/surabayakota/wiyung/wiyung
TPS 13,472,283,44,235,279,4,283,https://pilkada2015.kpu.go.id/surabayakota/wiyung/wiyung
TPS 14,472,266,23,239,262,4,266,https://pilkada2015.kpu.go.id/surabayakota/wiyung/wiyung
TPS 15,464,279,39,238,277,2,279,https://pilkada2015.kpu.go.id/surabayakota/wiyung/wiyung
TPS 16,618,337,39,286,325,12,337,https://pilkada2015.kpu.go.id/surabayakota/wiyung/wiyung
TPS 17,469,311,31,273,304,7,311,https://pilkada2015.kpu.go.id/surabayakota/wiyung/wiyung
TPS 18,541,333,25,302,327,6,333,https://pilkada2015.kpu.go.id/surabayakota/wiyung/wiyung
TPS 19,396,247,25,222,247,0,247,https://pilkada2015.kpu.go.id/surabayakota/wiyung/wiyung
TPS 20,558,328,15,312,327,1,328,https://pilkada2015.kpu.go.id/surabayakota/wiyung/wiyung
TPS 21,526,183,13,168,181,2,183,https://pilkada2015.kpu.go.id/surabayakota/wiyung/wiyung
TPS 22,640,317,16,301,317,0,317,https://pilkada2015.kpu.go.id/surabayakota/wiyung/wiyung
TPS 23,608,254,15,238,253,1,254,https://pilkada2015.kpu.go.id/surabayakota/wiyung/wiyung
TPS 1,514,263,66,192,258,5,263,https://pilkada2015.kpu.go.id/surabayakota/wonocolo/bendul_merisi
TPS 2,520,220,35,183,218,2,220,https://pilkada2015.kpu.go.id/surabayakota/wonocolo/bendul_merisi
TPS 3,455,180,27,149,176,4,180,https://pilkada2015.kpu.go.id/surabayakota/wonocolo/bendul_merisi
TPS 4,511,245,18,223,241,4,245,https://pilkada2015.kpu.go.id/surabayakota/wonocolo/bendul_merisi
TPS 5,504,251,34,212,246,5,251,https://pilkada2015.kpu.go.id/surabayakota/wonocolo/bendul_merisi
TPS 6,370,238,39,195,234,4,238,https://pilkada2015.kpu.go.id/surabayakota/wonocolo/bendul_merisi
TPS 7,358,224,40,180,220,4,224,https://pilkada2015.kpu.go.id/surabayakota/wonocolo/bendul_merisi
TPS 8,490,213,24,182,206,7,213,https://pilkada2015.kpu.go.id/surabayakota/wonocolo/bendul_merisi
TPS 9,433,235,40,186,226,9,235,https://pilkada2015.kpu.go.id/surabayakota/wonocolo/bendul_merisi
TPS 10,395,233,24,207,231,2,233,https://pilkada2015.kpu.go.id/surabayakota/wonocolo/bendul_merisi
TPS 11,646,353,40,306,346,7,353,https://pilkada2015.kpu.go.id/surabayakota/wonocolo/bendul_merisi
TPS 12,529,281,41,231,272,9,281,https://pilkada2015.kpu.go.id/surabayakota/wonocolo/bendul_merisi
TPS 13,569,370,43,322,365,5,370,https://pilkada2015.kpu.go.id/surabayakota/wonocolo/bendul_merisi
TPS 14,498,287,28,253,281,6,287,https://pilkada2015.kpu.go.id/surabayakota/wonocolo/bendul_merisi
TPS 15,516,246,24,221,245,1,246,https://pilkada2015.kpu.go.id/surabayakota/wonocolo/bendul_merisi
TPS 16,619,350,61,287,348,2,350,https://pilkada2015.kpu.go.id/surabayakota/wonocolo/bendul_merisi
TPS 17,619,340,41,294,335,5,340,https://pilkada2015.kpu.go.id/surabayakota/wonocolo/bendul_merisi
TPS 18,572,337,40,292,332,5,337,https://pilkada2015.kpu.go.id/surabayakota/wonocolo/bendul_merisi
TPS 19,554,274,17,254,271,3,274,https://pilkada2015.kpu.go.id/surabayakota/wonocolo/bendul_merisi
TPS 20,481,228,18,208,226,2,228,https://pilkada2015.kpu.go.id/surabayakota/wonocolo/bendul_merisi
TPS 21,589,347,30,312,342,5,347,https://pilkada2015.kpu.go.id/surabayakota/wonocolo/bendul_merisi
TPS 22,586,240,34,200,234,6,240,https://pilkada2015.kpu.go.id/surabayakota/wonocolo/bendul_merisi
TPS 1,505,166,15,150,165,1,166,https://pilkada2015.kpu.go.id/surabayakota/wonocolo/jemur_wonosari
TPS 2,309,189,16,173,189,0,189,https://pilkada2015.kpu.go.id/surabayakota/wonocolo/jemur_wonosari
TPS 3,346,245,27,218,245,0,245,https://pilkada2015.kpu.go.id/surabayakota/wonocolo/jemur_wonosari
TPS 4,536,267,37,227,264,3,267,https://pilkada2015.kpu.go.id/surabayakota/wonocolo/jemur_wonosari
TPS 5,649,324,26,293,319,5,324,https://pilkada2015.kpu.go.id/surabayakota/wonocolo/jemur_wonosari
TPS 6,513,280,32,243,275,5,280,https://pilkada2015.kpu.go.id/surabayakota/wonocolo/jemur_wonosari
TPS 7,478,287,28,246,274,13,287,https://pilkada2015.kpu.go.id/surabayakota/wonocolo/jemur_wonosari
TPS 8,414,257,18,236,254,3,257,https://pilkada2015.kpu.go.id/surabayakota/wonocolo/jemur_wonosari
TPS 9,402,162,16,145,161,1,162,https://pilkada2015.kpu.go.id/surabayakota/wonocolo/jemur_wonosari
TPS 10,632,431,44,382,426,5,431,https://pilkada2015.kpu.go.id/surabayakota/wonocolo/jemur_wonosari
TPS 11,627,394,48,342,390,4,394,https://pilkada2015.kpu.go.id/surabayakota/wonocolo/jemur_wonosari
TPS 12,498,363,67,291,358,5,363,https://pilkada2015.kpu.go.id/surabayakota/wonocolo/jemur_wonosari
TPS 13,475,242,54,185,239,3,242,https://pilkada2015.kpu.go.id/surabayakota/wonocolo/jemur_wonosari
TPS 14,701,428,67,353,420,8,428,https://pilkada2015.kpu.go.id/surabayakota/wonocolo/jemur_wonosari
TPS 15,586,281,42,233,275,6,281,https://pilkada2015.kpu.go.id/surabayakota/wonocolo/jemur_wonosari
TPS 16,487,254,36,216,252,2,254,https://pilkada2015.kpu.go.id/surabayakota/wonocolo/jemur_wonosari
TPS 17,686,370,56,307,363,7,370,https://pilkada2015.kpu.go.id/surabayakota/wonocolo/jemur_wonosari
TPS 18,630,342,40,295,335,7,342,https://pilkada2015.kpu.go.id/surabayakota/wonocolo/jemur_wonosari
TPS 19,618,318,39,272,311,7,318,https://pilkada2015.kpu.go.id/surabayakota/wonocolo/jemur_wonosari
TPS 20,508,262,44,213,257,5,262,https://pilkada2015.kpu.go.id/surabayakota/wonocolo/jemur_wonosari
TPS 21,460,211,25,182,207,4,211,https://pilkada2015.kpu.go.id/surabayakota/wonocolo/jemur_wonosari
TPS 22,379,200,13,185,198,2,200,https://pilkada2015.kpu.go.id/surabayakota/wonocolo/jemur_wonosari
TPS 23,532,237,20,214,234,3,237,https://pilkada2015.kpu.go.id/surabayakota/wonocolo/jemur_wonosari
TPS 24,447,163,18,145,163,0,163,https://pilkada2015.kpu.go.id/surabayakota/wonocolo/jemur_wonosari
TPS 25,680,341,290,44,334,0,341,https://pilkada2015.kpu.go.id/surabayakota/wonocolo/jemur_wonosari
TPS 26,273,195,38,157,195,0,195,https://pilkada2015.kpu.go.id/surabayakota/wonocolo/jemur_wonosari
TPS 27,582,262,46,214,260,2,262,https://pilkada2015.kpu.go.id/surabayakota/wonocolo/jemur_wonosari
TPS 28,350,179,16,160,176,3,179,https://pilkada2015.kpu.go.id/surabayakota/wonocolo/jemur_wonosari
TPS 29,591,261,20,239,259,2,261,https://pilkada2015.kpu.go.id/surabayakota/wonocolo/jemur_wonosari
TPS 30,220,94,10,82,92,2,94,https://pilkada2015.kpu.go.id/surabayakota/wonocolo/jemur_wonosari
TPS 1,707,336,32,298,330,6,336,https://pilkada2015.kpu.go.id/surabayakota/wonocolo/margorejo
TPS 2,538,291,44,242,286,5,291,https://pilkada2015.kpu.go.id/surabayakota/wonocolo/margorejo
TPS 3,660,338,80,254,334,4,338,https://pilkada2015.kpu.go.id/surabayakota/wonocolo/margorejo
TPS 4,473,259,29,216,245,14,259,https://pilkada2015.kpu.go.id/surabayakota/wonocolo/margorejo
TPS 5,433,202,35,166,201,1,202,https://pilkada2015.kpu.go.id/surabayakota/wonocolo/margorejo
TPS 6,738,351,37,311,348,3,351,https://pilkada2015.kpu.go.id/surabayakota/wonocolo/margorejo
TPS 7,365,201,29,169,198,3,201,https://pilkada2015.kpu.go.id/surabayakota/wonocolo/margorejo
TPS 8,512,257,20,233,253,4,257,https://pilkada2015.kpu.go.id/surabayakota/wonocolo/margorejo
TPS 9,592,327,54,267,321,6,327,https://pilkada2015.kpu.go.id/surabayakota/wonocolo/margorejo
TPS 10,378,223,26,190,216,7,223,https://pilkada2015.kpu.go.id/surabayakota/wonocolo/margorejo
TPS 11,516,285,42,237,279,6,285,https://pilkada2015.kpu.go.id/surabayakota/wonocolo/margorejo
TPS 12,594,331,55,270,325,6,331,https://pilkada2015.kpu.go.id/surabayakota/wonocolo/margorejo
TPS 13,661,371,39,321,360,11,371,https://pilkada2015.kpu.go.id/surabayakota/wonocolo/margorejo
TPS 14,435,166,11,155,166,0,166,https://pilkada2015.kpu.go.id/surabayakota/wonocolo/margorejo
TPS 15,612,244,19,224,243,1,244,https://pilkada2015.kpu.go.id/surabayakota/wonocolo/margorejo
TPS 16,404,114,17,97,114,0,114,https://pilkada2015.kpu.go.id/surabayakota/wonocolo/margorejo
TPS 1,566,303,28,274,302,1,303,https://pilkada2015.kpu.go.id/surabayakota/wonocolo/sidosermo
TPS 2,538,210,33,171,204,6,210,https://pilkada2015.kpu.go.id/surabayakota/wonocolo/sidosermo
TPS 3,521,315,36,271,307,8,315,https://pilkada2015.kpu.go.id/surabayakota/wonocolo/sidosermo
TPS 4,546,276,41,228,269,7,276,https://pilkada2015.kpu.go.id/surabayakota/wonocolo/sidosermo
TPS 5,513,285,22,256,278,7,285,https://pilkada2015.kpu.go.id/surabayakota/wonocolo/sidosermo
TPS 6,500,320,43,268,311,9,320,https://pilkada2015.kpu.go.id/surabayakota/wonocolo/sidosermo
TPS 7,555,230,16,212,228,2,230,https://pilkada2015.kpu.go.id/surabayakota/wonocolo/sidosermo
TPS 8,580,328,58,267,325,3,328,https://pilkada2015.kpu.go.id/surabayakota/wonocolo/sidosermo
TPS 9,554,298,48,245,293,6,299,https://pilkada2015.kpu.go.id/surabayakota/wonocolo/sidosermo
TPS 10,581,295,35,256,291,4,295,https://pilkada2015.kpu.go.id/surabayakota/wonocolo/sidosermo
TPS 11,570,256,26,229,255,1,256,https://pilkada2015.kpu.go.id/surabayakota/wonocolo/sidosermo
TPS 12,544,311,40,267,307,4,311,https://pilkada2015.kpu.go.id/surabayakota/wonocolo/sidosermo
TPS 13,561,265,44,218,262,3,265,https://pilkada2015.kpu.go.id/surabayakota/wonocolo/sidosermo
TPS 14,557,185,23,161,184,1,185,https://pilkada2015.kpu.go.id/surabayakota/wonocolo/sidosermo
TPS 15,568,228,27,200,227,1,228,https://pilkada2015.kpu.go.id/surabayakota/wonocolo/sidosermo
TPS 16,612,322,35,284,319,3,322,https://pilkada2015.kpu.go.id/surabayakota/wonocolo/sidosermo
TPS 17,472,204,31,170,201,3,204,https://pilkada2015.kpu.go.id/surabayakota/wonocolo/sidosermo
TPS 1,486,249,28,220,248,1,249,https://pilkada2015.kpu.go.id/surabayakota/wonocolo/siwalan_kerto
TPS 2,607,336,64,265,329,7,336,https://pilkada2015.kpu.go.id/surabayakota/wonocolo/siwalan_kerto
TPS 3,493,325,32,292,324,1,325,https://pilkada2015.kpu.go.id/surabayakota/wonocolo/siwalan_kerto
TPS 4,367,221,21,197,218,3,221,https://pilkada2015.kpu.go.id/surabayakota/wonocolo/siwalan_kerto
TPS 5,624,356,42,305,347,9,356,https://pilkada2015.kpu.go.id/surabayakota/wonocolo/siwalan_kerto
TPS 6,576,322,41,277,318,4,322,https://pilkada2015.kpu.go.id/surabayakota/wonocolo/siwalan_kerto
TPS 7,0,377,52,313,365,12,377,https://pilkada2015.kpu.go.id/surabayakota/wonocolo/siwalan_kerto
TPS 8,553,359,36,320,356,3,359,https://pilkada2015.kpu.go.id/surabayakota/wonocolo/siwalan_kerto
TPS 9,539,349,26,313,339,10,349,https://pilkada2015.kpu.go.id/surabayakota/wonocolo/siwalan_kerto
TPS 10,722,367,40,325,365,2,367,https://pilkada2015.kpu.go.id/surabayakota/wonocolo/siwalan_kerto
TPS 11,192,135,9,126,135,0,135,https://pilkada2015.kpu.go.id/surabayakota/wonocolo/siwalan_kerto
TPS 12,614,336,38,293,331,5,336,https://pilkada2015.kpu.go.id/surabayakota/wonocolo/siwalan_kerto
TPS 13,277,277,32,243,275,2,277,https://pilkada2015.kpu.go.id/surabayakota/wonocolo/siwalan_kerto
TPS 14,292,186,21,162,183,3,186,https://pilkada2015.kpu.go.id/surabayakota/wonocolo/siwalan_kerto
TPS 15,590,346,28,308,336,10,346,https://pilkada2015.kpu.go.id/surabayakota/wonocolo/siwalan_kerto
TPS 16,576,328,39,282,321,7,328,https://pilkada2015.kpu.go.id/surabayakota/wonocolo/siwalan_kerto
TPS 17,528,351,56,291,347,4,351,https://pilkada2015.kpu.go.id/surabayakota/wonocolo/siwalan_kerto
TPS 18,331,154,15,136,151,3,154,https://pilkada2015.kpu.go.id/surabayakota/wonocolo/siwalan_kerto
TPS 19,530,300,49,247,296,4,300,https://pilkada2015.kpu.go.id/surabayakota/wonocolo/siwalan_kerto
TPS 20,650,418,57,357,414,4,418,https://pilkada2015.kpu.go.id/surabayakota/wonocolo/siwalan_kerto
TPS 21,598,279,27,241,268,11,279,https://pilkada2015.kpu.go.id/surabayakota/wonocolo/siwalan_kerto
TPS 22,387,197,16,177,193,4,197,https://pilkada2015.kpu.go.id/surabayakota/wonocolo/siwalan_kerto
TPS 1,483,202,18,181,199,3,202,https://pilkada2015.kpu.go.id/surabayakota/wonokromo/darmo
TPS 2,479,152,10,142,152,0,152,https://pilkada2015.kpu.go.id/surabayakota/wonokromo/darmo
TPS 3,423,119,11,108,119,0,119,https://pilkada2015.kpu.go.id/surabayakota/wonokromo/darmo
TPS 4,613,336,42,282,324,12,336,https://pilkada2015.kpu.go.id/surabayakota/wonokromo/darmo
TPS 5,602,315,80,230,310,5,315,https://pilkada2015.kpu.go.id/surabayakota/wonokromo/darmo
TPS 6,415,192,32,157,189,3,192,https://pilkada2015.kpu.go.id/surabayakota/wonokromo/darmo
TPS 7,507,256,37,215,252,4,256,https://pilkada2015.kpu.go.id/surabayakota/wonokromo/darmo
TPS 8,434,251,40,206,246,5,251,https://pilkada2015.kpu.go.id/surabayakota/wonokromo/darmo
TPS 9,421,220,27,190,217,3,220,https://pilkada2015.kpu.go.id/surabayakota/wonokromo/darmo
TPS 10,470,235,18,214,232,3,235,https://pilkada2015.kpu.go.id/surabayakota/wonokromo/darmo
TPS 11,719,293,64,223,287,6,293,https://pilkada2015.kpu.go.id/surabayakota/wonokromo/darmo
TPS 12,510,205,50,143,193,12,205,https://pilkada2015.kpu.go.id/surabayakota/wonokromo/darmo
TPS 13,530,278,26,246,272,6,278,https://pilkada2015.kpu.go.id/surabayakota/wonokromo/darmo
TPS 14,572,309,28,274,302,7,309,https://pilkada2015.kpu.go.id/surabayakota/wonokromo/darmo
TPS 15,523,260,33,222,255,5,260,https://pilkada2015.kpu.go.id/surabayakota/wonokromo/darmo
TPS 16,471,180,18,161,179,1,180,https://pilkada2015.kpu.go.id/surabayakota/wonokromo/darmo
TPS 17,608,278,52,215,267,11,278,https://pilkada2015.kpu.go.id/surabayakota/wonokromo/darmo
TPS 18,460,198,20,178,198,0,198,https://pilkada2015.kpu.go.id/surabayakota/wonokromo/darmo
TPS 19,250,250,28,216,244,6,250,https://pilkada2015.kpu.go.id/surabayakota/wonokromo/darmo
TPS 20,427,203,22,179,201,2,203,https://pilkada2015.kpu.go.id/surabayakota/wonokromo/darmo
TPS 21,405,263,32,229,261,2,263,https://pilkada2015.kpu.go.id/surabayakota/wonokromo/darmo
TPS 22,489,217,35,181,216,1,217,https://pilkada2015.kpu.go.id/surabayakota/wonokromo/darmo
TPS 23,441,211,37,174,211,0,211,https://pilkada2015.kpu.go.id/surabayakota/wonokromo/darmo
TPS 1,516,246,40,202,242,4,246,https://pilkada2015.kpu.go.id/surabayakota/wonokromo/jagir
TPS 2,482,234,51,181,232,2,234,https://pilkada2015.kpu.go.id/surabayakota/wonokromo/jagir
TPS 3,429,233,40,191,231,2,233,https://pilkada2015.kpu.go.id/surabayakota/wonokromo/jagir
TPS 4,387,232,54,175,229,3,232,https://pilkada2015.kpu.go.id/surabayakota/wonokromo/jagir
TPS 5,394,194,52,141,193,1,194,https://pilkada2015.kpu.go.id/surabayakota/wonokromo/jagir
TPS 6,806,290,47,241,288,2,290,https://pilkada2015.kpu.go.id/surabayakota/wonokromo/jagir
TPS 7,588,210,46,159,205,5,210,https://pilkada2015.kpu.go.id/surabayakota/wonokromo/jagir
TPS 8,463,142,23,119,142,0,142,https://pilkada2015.kpu.go.id/surabayakota/wonokromo/jagir
TPS 9,370,215,44,164,208,7,215,https://pilkada2015.kpu.go.id/surabayakota/wonokromo/jagir
TPS 10,602,320,53,260,313,7,320,https://pilkada2015.kpu.go.id/surabayakota/wonokromo/jagir
TPS 11,355,355,59,284,343,12,355,https://pilkada2015.kpu.go.id/surabayakota/wonokromo/jagir
TPS 12,679,281,37,236,273,8,281,https://pilkada2015.kpu.go.id/surabayakota/wonokromo/jagir
TPS 13,643,261,39,217,256,5,261,https://pilkada2015.kpu.go.id/surabayakota/wonokromo/jagir
TPS 14,694,274,35,233,268,6,274,https://pilkada2015.kpu.go.id/surabayakota/wonokromo/jagir
TPS 15,513,289,46,239,285,4,289,https://pilkada2015.kpu.go.id/surabayakota/wonokromo/jagir
TPS 16,578,365,46,312,358,7,365,https://pilkada2015.kpu.go.id/surabayakota/wonokromo/jagir
TPS 17,595,315,41,269,310,5,315,https://pilkada2015.kpu.go.id/surabayakota/wonokromo/jagir
TPS 18,557,249,40,207,247,2,249,https://pilkada2015.kpu.go.id/surabayakota/wonokromo/jagir
TPS 19,568,293,32,254,286,7,293,https://pilkada2015.kpu.go.id/surabayakota/wonokromo/jagir
TPS 20,336,178,30,145,175,3,178,https://pilkada2015.kpu.go.id/surabayakota/wonokromo/jagir
TPS 21,505,293,44,246,290,3,293,https://pilkada2015.kpu.go.id/surabayakota/wonokromo/jagir
TPS 22,317,138,16,119,135,3,138,https://pilkada2015.kpu.go.id/surabayakota/wonokromo/jagir
TPS 23,405,194,43,150,193,1,194,https://pilkada2015.kpu.go.id/surabayakota/wonokromo/jagir
TPS 24,485,183,18,163,181,2,183,https://pilkada2015.kpu.go.id/surabayakota/wonokromo/jagir
TPS 25,299,183,56,125,181,2,183,https://pilkada2015.kpu.go.id/surabayakota/wonokromo/jagir
TPS 26,116,62,5,56,61,1,62,https://pilkada2015.kpu.go.id/surabayakota/wonokromo/jagir
TPS 27,732,305,35,267,302,3,305,https://pilkada2015.kpu.go.id/surabayakota/wonokromo/jagir
TPS 28,649,261,41,213,254,7,261,https://pilkada2015.kpu.go.id/surabayakota/wonokromo/jagir
TPS 29,368,212,34,169,203,9,212,https://pilkada2015.kpu.go.id/surabayakota/wonokromo/jagir
TPS 30,437,264,39,224,263,1,264,https://pilkada2015.kpu.go.id/surabayakota/wonokromo/jagir
TPS 1,540,304,40,260,300,4,304,https://pilkada2015.kpu.go.id/surabayakota/wonokromo/ngagel
TPS 2,479,284,29,250,279,5,284,https://pilkada2015.kpu.go.id/surabayakota/wonokromo/ngagel
TPS 3,0,0,26,266,292,3,295,https://pilkada2015.kpu.go.id/surabayakota/wonokromo/ngagel
TPS 4,413,269,15,244,259,10,269,https://pilkada2015.kpu.go.id/surabayakota/wonokromo/ngagel
TPS 5,428,250,33,214,247,3,250,https://pilkada2015.kpu.go.id/surabayakota/wonokromo/ngagel
TPS 6,543,275,15,256,271,4,275,https://pilkada2015.kpu.go.id/surabayakota/wonokromo/ngagel
TPS 7,598,279,14,262,276,3,279,https://pilkada2015.kpu.go.id/surabayakota/wonokromo/ngagel
TPS 8,470,237,38,195,233,4,237,https://pilkada2015.kpu.go.id/surabayakota/wonokromo/ngagel
TPS 9,445,214,51,158,209,5,214,https://pilkada2015.kpu.go.id/surabayakota/wonokromo/ngagel
TPS 10,455,279,62,210,272,7,279,https://pilkada2015.kpu.go.id/surabayakota/wonokromo/ngagel
TPS 11,536,253,44,204,248,5,253,https://pilkada2015.kpu.go.id/surabayakota/wonokromo/ngagel
TPS 12,592,358,40,316,356,2,358,https://pilkada2015.kpu.go.id/surabayakota/wonokromo/ngagel
TPS 13,411,187,22,163,185,2,187,https://pilkada2015.kpu.go.id/surabayakota/wonokromo/ngagel
TPS 14,429,281,47,226,273,8,281,https://pilkada2015.kpu.go.id/surabayakota/wonokromo/ngagel
TPS 15,459,225,26,196,222,3,225,https://pilkada2015.kpu.go.id/surabayakota/wonokromo/ngagel
TPS 16,585,312,35,274,309,3,312,https://pilkada2015.kpu.go.id/surabayakota/wonokromo/ngagel
TPS 17,493,260,107,148,255,5,260,https://pilkada2015.kpu.go.id/surabayakota/wonokromo/ngagel
TPS 1,643,363,39,318,357,9,366,https://pilkada2015.kpu.go.id/surabayakota/wonokromo/ngagel_rejo
TPS 2,674,402,33,365,398,4,402,https://pilkada2015.kpu.go.id/surabayakota/wonokromo/ngagel_rejo
TPS 3,563,311,50,254,304,7,311,https://pilkada2015.kpu.go.id/surabayakota/wonokromo/ngagel_rejo
TPS 4,532,273,32,238,270,3,273,https://pilkada2015.kpu.go.id/surabayakota/wonokromo/ngagel_rejo
TPS 5,582,286,61,222,283,3,286,https://pilkada2015.kpu.go.id/surabayakota/wonokromo/ngagel_rejo
TPS 6,501,266,43,216,259,7,266,https://pilkada2015.kpu.go.id/surabayakota/wonokromo/ngagel_rejo
TPS 7,506,285,21,261,282,3,285,https://pilkada2015.kpu.go.id/surabayakota/wonokromo/ngagel_rejo
TPS 8,544,234,20,214,234,0,234,https://pilkada2015.kpu.go.id/surabayakota/wonokromo/ngagel_rejo
TPS 9,524,313,61,250,311,2,313,https://pilkada2015.kpu.go.id/surabayakota/wonokromo/ngagel_rejo
TPS 10,455,267,53,210,263,4,267,https://pilkada2015.kpu.go.id/surabayakota/wonokromo/ngagel_rejo
TPS 11,564,311,38,266,304,7,311,https://pilkada2015.kpu.go.id/surabayakota/wonokromo/ngagel_rejo
TPS 12,533,294,52,233,285,9,294,https://pilkada2015.kpu.go.id/surabayakota/wonokromo/ngagel_rejo
TPS 13,510,298,60,231,291,7,298,https://pilkada2015.kpu.go.id/surabayakota/wonokromo/ngagel_rejo
TPS 14,490,274,50,216,266,8,274,https://pilkada2015.kpu.go.id/surabayakota/wonokromo/ngagel_rejo
TPS 15,541,338,44,291,335,3,338,https://pilkada2015.kpu.go.id/surabayakota/wonokromo/ngagel_rejo
TPS 16,416,269,32,229,261,8,269,https://pilkada2015.kpu.go.id/surabayakota/wonokromo/ngagel_rejo
TPS 17,490,278,31,240,271,7,278,https://pilkada2015.kpu.go.id/surabayakota/wonokromo/ngagel_rejo
TPS 18,533,306,44,255,299,7,306,https://pilkada2015.kpu.go.id/surabayakota/wonokromo/ngagel_rejo
TPS 19,557,305,28,275,303,2,305,https://pilkada2015.kpu.go.id/surabayakota/wonokromo/ngagel_rejo
TPS 20,503,241,41,198,239,2,241,https://pilkada2015.kpu.go.id/surabayakota/wonokromo/ngagel_rejo
TPS 21,515,320,43,271,314,6,320,https://pilkada2015.kpu.go.id/surabayakota/wonokromo/ngagel_rejo
TPS 22,504,244,31,210,241,3,244,https://pilkada2015.kpu.go.id/surabayakota/wonokromo/ngagel_rejo
TPS 23,542,290,43,236,279,11,290,https://pilkada2015.kpu.go.id/surabayakota/wonokromo/ngagel_rejo
TPS 24,498,320,58,258,316,4,320,https://pilkada2015.kpu.go.id/surabayakota/wonokromo/ngagel_rejo
TPS 25,507,319,45,264,309,10,319,https://pilkada2015.kpu.go.id/surabayakota/wonokromo/ngagel_rejo
TPS 26,502,289,45,243,288,1,289,https://pilkada2015.kpu.go.id/surabayakota/wonokromo/ngagel_rejo
TPS 27,516,271,66,204,270,1,271,https://pilkada2015.kpu.go.id/surabayakota/wonokromo/ngagel_rejo
TPS 28,482,264,39,222,261,3,264,https://pilkada2015.kpu.go.id/surabayakota/wonokromo/ngagel_rejo
TPS 29,480,271,36,228,264,7,271,https://pilkada2015.kpu.go.id/surabayakota/wonokromo/ngagel_rejo
TPS 30,518,322,34,285,319,3,322,https://pilkada2015.kpu.go.id/surabayakota/wonokromo/ngagel_rejo
TPS 31,548,286,47,234,281,5,286,https://pilkada2015.kpu.go.id/surabayakota/wonokromo/ngagel_rejo
TPS 32,527,245,15,229,244,1,245,https://pilkada2015.kpu.go.id/surabayakota/wonokromo/ngagel_rejo
TPS 33,511,252,35,214,249,3,252,https://pilkada2015.kpu.go.id/surabayakota/wonokromo/ngagel_rejo
TPS 34,508,284,36,246,282,2,284,https://pilkada2015.kpu.go.id/surabayakota/wonokromo/ngagel_rejo
TPS 35,452,265,35,226,261,4,265,https://pilkada2015.kpu.go.id/surabayakota/wonokromo/ngagel_rejo
TPS 36,494,284,48,232,280,4,284,https://pilkada2015.kpu.go.id/surabayakota/wonokromo/ngagel_rejo
TPS 37,490,245,35,206,241,4,245,https://pilkada2015.kpu.go.id/surabayakota/wonokromo/ngagel_rejo
TPS 38,482,269,28,238,266,3,269,https://pilkada2015.kpu.go.id/surabayakota/wonokromo/ngagel_rejo
TPS 39,531,273,25,244,269,4,273,https://pilkada2015.kpu.go.id/surabayakota/wonokromo/ngagel_rejo
TPS 40,527,287,54,230,284,3,287,https://pilkada2015.kpu.go.id/surabayakota/wonokromo/ngagel_rejo
TPS 41,559,327,27,300,327,0,327,https://pilkada2015.kpu.go.id/surabayakota/wonokromo/ngagel_rejo
TPS 42,496,284,18,263,281,3,284,https://pilkada2015.kpu.go.id/surabayakota/wonokromo/ngagel_rejo
TPS 43,530,272,35,230,265,7,272,https://pilkada2015.kpu.go.id/surabayakota/wonokromo/ngagel_rejo
TPS 44,233,233,31,200,231,2,233,https://pilkada2015.kpu.go.id/surabayakota/wonokromo/ngagel_rejo
TPS 45,412,237,24,211,235,2,237,https://pilkada2015.kpu.go.id/surabayakota/wonokromo/ngagel_rejo
TPS 46,521,276,35,235,270,6,276,https://pilkada2015.kpu.go.id/surabayakota/wonokromo/ngagel_rejo
TPS 47,631,334,62,268,330,4,334,https://pilkada2015.kpu.go.id/surabayakota/wonokromo/ngagel_rejo
TPS 48,629,353,54,287,341,12,353,https://pilkada2015.kpu.go.id/surabayakota/wonokromo/ngagel_rejo
TPS 49,535,325,52,269,321,4,325,https://pilkada2015.kpu.go.id/surabayakota/wonokromo/ngagel_rejo
TPS 50,495,194,29,161,190,4,194,https://pilkada2015.kpu.go.id/surabayakota/wonokromo/ngagel_rejo
TPS 51,555,308,41,259,300,8,308,https://pilkada2015.kpu.go.id/surabayakota/wonokromo/ngagel_rejo
TPS 52,527,319,52,259,311,8,319,https://pilkada2015.kpu.go.id/surabayakota/wonokromo/ngagel_rejo
TPS 53,629,347,36,297,333,14,347,https://pilkada2015.kpu.go.id/surabayakota/wonokromo/ngagel_rejo
TPS 54,612,299,27,264,291,8,299,https://pilkada2015.kpu.go.id/surabayakota/wonokromo/ngagel_rejo
TPS 55,474,287,56,230,286,1,287,https://pilkada2015.kpu.go.id/surabayakota/wonokromo/ngagel_rejo
TPS 56,459,279,82,192,274,5,279,https://pilkada2015.kpu.go.id/surabayakota/wonokromo/ngagel_rejo
TPS 57,494,266,41,225,266,0,266,https://pilkada2015.kpu.go.id/surabayakota/wonokromo/ngagel_rejo
TPS 58,517,311,46,263,309,2,311,https://pilkada2015.kpu.go.id/surabayakota/wonokromo/ngagel_rejo
TPS 59,472,252,12,237,249,3,252,https://pilkada2015.kpu.go.id/surabayakota/wonokromo/ngagel_rejo
TPS 60,490,334,36,296,332,2,334,https://pilkada2015.kpu.go.id/surabayakota/wonokromo/ngagel_rejo
TPS 1,443,258,35,222,257,1,258,https://pilkada2015.kpu.go.id/surabayakota/wonokromo/sawunggaling
TPS 2,490,266,24,240,264,2,266,https://pilkada2015.kpu.go.id/surabayakota/wonokromo/sawunggaling
TPS 3,509,293,36,251,287,6,293,https://pilkada2015.kpu.go.id/surabayakota/wonokromo/sawunggaling
TPS 4,517,286,26,256,282,4,286,https://pilkada2015.kpu.go.id/surabayakota/wonokromo/sawunggaling
TPS 5,490,286,37,244,281,5,286,https://pilkada2015.kpu.go.id/surabayakota/wonokromo/sawunggaling
TPS 6,398,199,21,176,197,2,199,https://pilkada2015.kpu.go.id/surabayakota/wonokromo/sawunggaling
TPS 7,441,222,33,185,218,4,222,https://pilkada2015.kpu.go.id/surabayakota/wonokromo/sawunggaling
TPS 8,520,292,32,256,288,4,292,https://pilkada2015.kpu.go.id/surabayakota/wonokromo/sawunggaling
TPS 9,490,277,32,237,269,8,277,https://pilkada2015.kpu.go.id/surabayakota/wonokromo/sawunggaling
TPS 10,357,186,18,162,180,6,186,https://pilkada2015.kpu.go.id/surabayakota/wonokromo/sawunggaling
TPS 11,523,287,80,200,280,7,287,https://pilkada2015.kpu.go.id/surabayakota/wonokromo/sawunggaling
TPS 12,481,298,49,241,290,8,298,https://pilkada2015.kpu.go.id/surabayakota/wonokromo/sawunggaling
TPS 13,571,309,56,247,303,6,309,https://pilkada2015.kpu.go.id/surabayakota/wonokromo/sawunggaling
TPS 14,449,272,43,222,265,7,272,https://pilkada2015.kpu.go.id/surabayakota/wonokromo/sawunggaling
TPS 15,508,300,61,234,295,5,300,https://pilkada2015.kpu.go.id/surabayakota/wonokromo/sawunggaling
TPS 16,389,253,74,175,249,4,253,https://pilkada2015.kpu.go.id/surabayakota/wonokromo/sawunggaling
TPS 17,363,232,35,195,230,2,232,https://pilkada2015.kpu.go.id/surabayakota/wonokromo/sawunggaling
TPS 18,538,296,80,208,288,8,296,https://pilkada2015.kpu.go.id/surabayakota/wonokromo/sawunggaling
TPS 19,759,287,150,126,276,11,287,https://pilkada2015.kpu.go.id/surabayakota/wonokromo/sawunggaling
TPS 20,648,345,153,182,335,10,345,https://pilkada2015.kpu.go.id/surabayakota/wonokromo/sawunggaling
TPS 21,446,229,31,197,228,1,229,https://pilkada2015.kpu.go.id/surabayakota/wonokromo/sawunggaling
TPS 22,533,298,55,238,293,5,298,https://pilkada2015.kpu.go.id/surabayakota/wonokromo/sawunggaling
TPS 23,446,237,48,188,236,1,237,https://pilkada2015.kpu.go.id/surabayakota/wonokromo/sawunggaling
TPS 24,403,270,60,194,254,16,270,https://pilkada2015.kpu.go.id/surabayakota/wonokromo/sawunggaling
TPS 25,554,320,14,302,316,4,320,https://pilkada2015.kpu.go.id/surabayakota/wonokromo/sawunggaling
TPS 26,469,236,41,171,212,24,236,https://pilkada2015.kpu.go.id/surabayakota/wonokromo/sawunggaling
TPS 27,467,262,44,215,259,3,262,https://pilkada2015.kpu.go.id/surabayakota/wonokromo/sawunggaling
TPS 28,404,236,40,192,232,4,236,https://pilkada2015.kpu.go.id/surabayakota/wonokromo/sawunggaling
TPS 29,383,222,28,187,215,7,222,https://pilkada2015.kpu.go.id/surabayakota/wonokromo/sawunggaling
TPS 30,459,190,44,144,188,2,190,https://pilkada2015.kpu.go.id/surabayakota/wonokromo/sawunggaling
TPS 31,410,96,22,72,94,2,96,https://pilkada2015.kpu.go.id/surabayakota/wonokromo/sawunggaling
TPS 32,589,153,30,121,151,2,153,https://pilkada2015.kpu.go.id/surabayakota/wonokromo/sawunggaling
TPS 33,435,263,53,206,259,4,263,https://pilkada2015.kpu.go.id/surabayakota/wonokromo/sawunggaling
TPS 34,291,192,51,137,188,4,192,https://pilkada2015.kpu.go.id/surabayakota/wonokromo/sawunggaling
TPS 35,332,193,51,138,189,4,193,https://pilkada2015.kpu.go.id/surabayakota/wonokromo/sawunggaling
TPS 36,473,307,71,230,301,6,307,https://pilkada2015.kpu.go.id/surabayakota/wonokromo/sawunggaling
TPS 37,314,166,35,130,165,1,166,https://pilkada2015.kpu.go.id/surabayakota/wonokromo/sawunggaling
TPS 38,472,222,67,151,218,4,222,https://pilkada2015.kpu.go.id/surabayakota/wonokromo/sawunggaling
TPS 39,495,276,66,207,273,3,276,https://pilkada2015.kpu.go.id/surabayakota/wonokromo/sawunggaling
TPS 1,481,275,34,237,271,4,275,https://pilkada2015.kpu.go.id/surabayakota/wonokromo/wonokromo
TPS 2,512,246,27,216,243,3,246,https://pilkada2015.kpu.go.id/surabayakota/wonokromo/wonokromo
TPS 3,512,280,34,243,277,3,280,https://pilkada2015.kpu.go.id/surabayakota/wonokromo/wonokromo
TPS 4,501,307,34,267,301,6,307,https://pilkada2015.kpu.go.id/surabayakota/wonokromo/wonokromo
TPS 5,358,246,22,216,238,8,246,https://pilkada2015.kpu.go.id/surabayakota/wonokromo/wonokromo
TPS 6,454,263,33,225,258,5,263,https://pilkada2015.kpu.go.id/surabayakota/wonokromo/wonokromo
TPS 7,533,221,34,182,216,5,221,https://pilkada2015.kpu.go.id/surabayakota/wonokromo/wonokromo
TPS 8,493,260,27,231,258,2,260,https://pilkada2015.kpu.go.id/surabayakota/wonokromo/wonokromo
TPS 9,267,264,42,219,261,3,264,https://pilkada2015.kpu.go.id/surabayakota/wonokromo/wonokromo
TPS 10,478,231,39,187,226,5,231,https://pilkada2015.kpu.go.id/surabayakota/wonokromo/wonokromo
TPS 11,524,307,41,265,306,1,307,https://pilkada2015.kpu.go.id/surabayakota/wonokromo/wonokromo
TPS 12,434,273,31,238,269,4,273,https://pilkada2015.kpu.go.id/surabayakota/wonokromo/wonokromo
TPS 13,523,260,42,217,259,1,260,https://pilkada2015.kpu.go.id/surabayakota/wonokromo/wonokromo
TPS 14,566,251,19,228,247,4,251,https://pilkada2015.kpu.go.id/surabayakota/wonokromo/wonokromo
TPS 15,536,266,36,224,260,6,266,https://pilkada2015.kpu.go.id/surabayakota/wonokromo/wonokromo
TPS 16,674,314,274,36,310,4,314,https://pilkada2015.kpu.go.id/surabayakota/wonokromo/wonokromo
TPS 17,598,298,30,267,297,1,298,https://pilkada2015.kpu.go.id/surabayakota/wonokromo/wonokromo
TPS 18,393,255,27,217,244,11,255,https://pilkada2015.kpu.go.id/surabayakota/wonokromo/wonokromo
TPS 19,487,313,57,251,308,5,313,https://pilkada2015.kpu.go.id/surabayakota/wonokromo/wonokromo
TPS 20,520,273,35,232,267,6,273,https://pilkada2015.kpu.go.id/surabayakota/wonokromo/wonokromo
TPS 21,353,267,36,227,263,4,267,https://pilkada2015.kpu.go.id/surabayakota/wonokromo/wonokromo
TPS 22,504,310,34,268,302,8,310,https://pilkada2015.kpu.go.id/surabayakota/wonokromo/wonokromo
TPS 23,495,29,35,254,289,4,293,https://pilkada2015.kpu.go.id/surabayakota/wonokromo/wonokromo
TPS 24,505,238,39,198,237,1,238,https://pilkada2015.kpu.go.id/surabayakota/wonokromo/wonokromo
TPS 25,481,279,31,243,274,5,279,https://pilkada2015.kpu.go.id/surabayakota/wonokromo/wonokromo
TPS 26,518,261,32,222,254,7,261,https://pilkada2015.kpu.go.id/surabayakota/wonokromo/wonokromo
TPS 27,498,272,29,241,270,2,272,https://pilkada2015.kpu.go.id/surabayakota/wonokromo/wonokromo
TPS 28,495,255,41,212,253,2,255,https://pilkada2015.kpu.go.id/surabayakota/wonokromo/wonokromo
TPS 29,519,258,40,211,251,7,258,https://pilkada2015.kpu.go.id/surabayakota/wonokromo/wonokromo
TPS 30,419,233,23,202,225,8,233,https://pilkada2015.kpu.go.id/surabayakota/wonokromo/wonokromo
TPS 31,552,245,32,212,244,1,245,https://pilkada2015.kpu.go.id/surabayakota/wonokromo/wonokromo
TPS 32,424,257,16,239,255,2,257,https://pilkada2015.kpu.go.id/surabayakota/wonokromo/wonokromo
TPS 33,425,261,45,213,258,3,261,https://pilkada2015.kpu.go.id/surabayakota/wonokromo/wonokromo
TPS 34,491,252,24,221,245,7,252,https://pilkada2015.kpu.go.id/surabayakota/wonokromo/wonokromo
TPS 35,381,211,26,184,210,1,211,https://pilkada2015.kpu.go.id/surabayakota/wonokromo/wonokromo
TPS 36,461,212,29,178,207,5,212,https://pilkada2015.kpu.go.id/surabayakota/wonokromo/wonokromo
TPS 37,0,197,30,164,194,3,197,https://pilkada2015.kpu.go.id/surabayakota/wonokromo/wonokromo
TPS 38,532,188,42,144,186,2,188,https://pilkada2015.kpu.go.id/surabayakota/wonokromo/wonokromo
TPS 39,536,255,33,216,249,6,255,https://pilkada2015.kpu.go.id/surabayakota/wonokromo/wonokromo
TPS 40,693,237,33,199,232,5,237,https://pilkada2015.kpu.go.id/surabayakota/wonokromo/wonokromo
TPS 41,506,243,31,210,241,2,243,https://pilkada2015.kpu.go.id/surabayakota/wonokromo/wonokromo
TPS 42,530,197,26,170,196,1,197,https://pilkada2015.kpu.go.id/surabayakota/wonokromo/wonokromo
TPS 43,548,213,35,178,213,2,215,https://pilkada2015.kpu.go.id/surabayakota/wonokromo/wonokromo
TPS 44,506,271,25,240,265,6,271,https://pilkada2015.kpu.go.id/surabayakota/wonokromo/wonokromo
TPS 45,573,306,27,273,300,6,306,https://pilkada2015.kpu.go.id/surabayakota/wonokromo/wonokromo
TPS 46,523,269,52,215,267,2,269,https://pilkada2015.kpu.go.id/surabayakota/wonokromo/wonokromo
TPS 47,549,215,28,182,210,5,215,https://pilkada2015.kpu.go.id/surabayakota/wonokromo/wonokromo
TPS 48,566,284,92,190,282,2,284,https://pilkada2015.kpu.go.id/surabayakota/wonokromo/wonokromo
TPS 49,549,327,30,296,326,1,327,https://pilkada2015.kpu.go.id/surabayakota/wonokromo/wonokromo
TPS 50,523,213,27,183,210,3,213,https://pilkada2015.kpu.go.id/surabayakota/wonokromo/wonokromo
TPS 51,536,276,27,245,272,4,276,https://pilkada2015.kpu.go.id/surabayakota/wonokromo/wonokromo
TPS 52,550,285,21,257,278,7,285,https://pilkada2015.kpu.go.id/surabayakota/wonokromo/wonokromo
TPS 53,376,222,26,191,217,5,222,https://pilkada2015.kpu.go.id/surabayakota/wonokromo/wonokromo
TPS 54,523,253,23,226,249,4,253,https://pilkada2015.kpu.go.id/surabayakota/wonokromo/wonokromo
TPS 55,556,288,28,254,282,6,288,https://pilkada2015.kpu.go.id/surabayakota/wonokromo/wonokromo
TPS 56,530,296,30,262,292,4,296,https://pilkada2015.kpu.go.id/surabayakota/wonokromo/wonokromo
TPS 57,536,263,35,222,257,6,263,https://pilkada2015.kpu.go.id/surabayakota/wonokromo/wonokromo
